tractid,totalpopulation,AJWVE002,white,black,AJWVE005,AJWVE006,AJWVE007,AJWVE008,AJWVE009,AJWVE010,AJWVE011,AJWVE012,AJWVE013,AJWVE014,AJWVE015,AJWVE016,AJWVE017,AJWVE018,AJWVE019,AJWVE020,AJWVE021,totalpop,geometry
421100,2100,1963,1607,29,0,244,6,0,77,0,77,137,99,0,0,0,0,6,32,0,32,3984.0,"POLYGON ((-13607908.8444897 4558541.818865373, -13607951.70261208 4558536.602323267, -13608080.49936225 4558521.23535207, -13608087.17848479 4558520.389114396, -13608123.46835467 4558516.300906373, -13608149.18326144 4558515.595699253, -13608226.66162608 4558513.622495208, -13608252.48812959 4558513.058028406, -13608277.53455205 4558512.917156628, -13608352.78657014 4558512.77641653, -13608377.94517177 4558512.776302001, -13608405.66366239 4558508.828599387, -13608489.15323734 4558496.84538217, -13608516.9826838 4558493.038947349, -13608563.06910102 4558482.324188543, -13608653.34957319 4558461.599827331, -13608702.10751222 4558461.599775765, -13608749.08435922 4558461.599984143, -13608779.36292106 4558461.740856581, -13608897.8071769 4558428.892590351, -13608912.1671153 4558424.945125174, -13608947.67813384 4558422.548298181, -13609054.21110456 4558415.499464543, -13609079.92560948 4558413.807319564, -13609089.83309522 4558413.102472269, -13609090.05552034 4558416.485842304, -13609090.94599637 4558426.636609636, -13609091.28002206 4558430.020309366, -13609092.17104379 4558439.888627787, -13609097.18035442 4558490.783238302, -13609098.0707399 4558505.304324211, -13609100.51991277 4558544.215469276, -13609116.66123739 4558731.864594441, -13609123.22912004 4558807.433154739, -13609125.23239399 4558834.079238469, -13609131.57770144 4558914.442019572, -13609133.69320646 4558941.229370924, -13609135.36282278 4558967.735301335, -13609138.03425371 4559006.225068789, -13609140.70599485 4559047.393988418, -13609142.48726735 4559074.041180422, -13609143.15496314 4559082.077308058, -13609145.49292303 4559106.609857048, -13609146.2722483 4559114.787004802, -13609148.38687154 4559143.266908062, -13609154.95519208 4559228.989653243, -13609156.29061596 4559245.062721962, -13609152.72831934 4559256.765362056, -13609131.35497738 4559259.021078609, -13609130.57598807 4559259.162352829, -13609119.11025154 4559259.726103747, -13609098.85010575 4559261.417718447, -13609080.92726403 4559266.070771138, -13609073.02360842 4559268.608509952, -13609068.01440208 4559270.723487227, -13609047.7543629 4559279.465213099, -13609051.98420447 4559284.963739484, -13609057.6615147 4559289.757393803, -13609061.55772618 4559295.819932164, -13609063.67273228 4559302.164932312, -13609064.67463052 4559310.060394717, -13609064.22966556 4559313.444404532, -13609063.56169441 4559318.943008131, -13609059.55421644 4559327.543303371, -13609048.97908447 4559334.452445058, -13609043.74656472 4559336.002933974, -13609027.04880574 4559338.4001393, -13609004.3397992 4559339.528053369, -13608979.29306277 4559339.24580311, -13608972.61338166 4559338.963857686, -13608939.1062305 4559337.695007098, -13608929.1992338 4559341.078855179, -13608921.29550667 4559343.898985611, -13608899.14263853 4559349.397745224, -13608889.12393463 4559351.935473557, -13608868.08458835 4559353.90915096, -13608866.19232425 4559354.191254537, -13608805.07794536 4559357.716148457, -13608784.14956216 4559358.984895968, -13608769.23284126 4559359.830925557, -13608724.81638591 4559362.650640434, -13608710.01071634 4559363.77882901, -13608694.53764826 4559364.90675152, -13608648.11730045 4559368.572862723, -13608632.75527146 4559369.841692708, -13608613.05175024 4559371.392767538, -13608554.27486484 4559376.186282832, -13608534.68294178 4559377.878214289, -13608517.87334179 4559379.28841239, -13608467.66831119 4559383.377123335, -13608450.97031809 4559384.927647689, -13608419.57818471 4559387.324904539, -13608325.73599226 4559394.938553051, -13608294.56646913 4559397.617443359, -13608281.31984856 4559397.758090182, -13608260.72559206 4559399.027351964, -13608206.73577005 4559402.552251467, -13608173.00593099 4559405.23113082, -13608159.64767674 4559404.949263775, -13608151.85527385 4559404.948809557, -13608126.02879545 4559401.988201722, -13608121.24195326 4559400.719225988, -13608088.29158452 4559392.118791875, -13608073.04103412 4559388.170754519, -13608059.79382338 4559383.659152525, -13608035.19229324 4559371.956213306, -13608000.46027228 4559346.295507725, -13607985.87778898 4559339.245980135, -13607981.98161485 4559337.97677005, -13607963.27975335 4559332.055064925, -13607951.36857966 4559329.376696735, -13607944.5779052 4559327.261573614, -13607938.12149682 4559325.146883911, -13607936.89718375 4559324.86470706, -13607925.09710097 4559318.378751433, -13607920.421946 4559314.995362761, -13607914.74457695 4559310.906155182, -13607907.95394445 4559305.830592186, -13607902.72188549 4559302.024071059, -13607896.26555175 4559294.974379309, -13607890.47663425 4559286.655501083, -13607885.46728246 4559279.324261084, -13607854.63175289 4559277.91415548, -13607762.45946747 4559274.107464805, -13607731.73500858 4559272.838573478, -13607710.0277229 4559272.274607487, -13607644.90588363 4559270.582436668, -13607623.19860268 4559270.159532892, -13607605.83318888 4559274.107226811, -13607553.62410245 4559286.232850554, -13607536.36967294 4559290.321443208, -13607516.88890208 4559289.757579634, -13607458.66866995 4559288.488463685, -13607439.2989432 4559288.065465207, -13607373.8431223 4559328.389415635, -13607361.26407037 4559336.285109137, -13607341.56065974 4559334.311209884, -13607288.12726532 4559329.094684605, -13607157.32689133 4559316.405312119, -13607131.61192738 4559314.008146135, -13607106.67608968 4559263.673732786, -13607103.1143836 4559241.678985892, -13607102.33468035 4559236.603233188, -13607092.76129875 4559176.118045437, -13607089.31067777 4559154.2644906, -13607083.63328529 4559077.00180134, -13607078.8466701 4559011.441959945, -13607064.37508325 4558845.640230831, -13607057.69580807 4558768.662024471, -13607055.58088258 4558738.068184128, -13607049.23558912 4558646.42842606, -13607047.23173049 4558615.975946175, -13607075.9524392 4558613.578747176, -13607077.95613241 4558614.283696038, -13607083.96719939 4558616.539775837, -13607087.08392656 4558612.591977329, -13607206.97514669 4558602.723233471, -13607246.93883337 4558599.480804442, -13607254.28596641 4558598.916768432, -13607276.77260721 4558597.647989432, -13607284.23075123 4558597.366170755, -13607387.98062872 4558586.792089682, -13607699.56382813 4558555.352860569, -13607803.53608774 4558544.920562035, -13607810.32685095 4558543.9336065, -13607830.92119313 4558541.395941824, -13607837.82298383 4558540.549965425, -13607851.96020805 4558540.691050118, -13607894.59565984 4558541.536857437, -13607908.8444897 4558541.818865373))"
421200,3575,3415,2642,43,4,425,0,19,282,0,282,160,121,0,0,0,0,39,0,0,0,14252.0,"POLYGON ((-13613666.28868148 4561563.793619493, -13613672.41104672 4561588.049748336, -13613678.31141476 4561611.460018138, -13613714.49027408 4561754.600260193, -13613714.82409545 4561755.728443876, -13613729.40688957 4561801.139200844, -13613713.93353702 4561805.369848895, -13613706.69786073 4561807.062275131, -13613696.90170699 4561809.459367032, -13613638.01323132 4561816.792960183, -13613637.45682034 4561816.934012, -13613615.19278574 4561821.164931246, -13613610.8515292 4561825.677429928, -13613597.60477007 4561828.075067662, -13613541.49948051 4561838.229138467, -13613522.79776764 4561841.754851995, -13613503.65097299 4561844.857309153, -13613446.54422497 4561854.02402097, -13613427.5085257 4561857.267894703, -13613408.25003467 4561860.370471924, -13613350.36421134 4561870.100989855, -13613331.21681312 4561873.34498255, -13613311.95883551 4561876.447388849, -13613254.40647191 4561885.896226462, -13613235.25958659 4561889.140050017, -13613213.8861615 4561892.383405272, -13613150.10014931 4561902.114625133, -13613128.83837816 4561905.499370599, -13613116.92679235 4561909.588832135, -13613100.67426454 4561913.537515984, -13613031.76761373 4561930.884263927, -13613015.51485009 4561933.281596258, -13612986.90575084 4561937.794899848, -13612968.76091251 4561940.473942218, -13612914.54803124 4561948.795143949, -13612896.51435749 4561951.756332368, -13612884.82606131 4561953.730908872, -13612849.64893924 4561959.654271235, -13612838.07176222 4561961.769786408, -13612816.14163673 4561965.15449319, -13612812.24573843 4561965.436291561, -13612768.0515826 4561969.526085997, -13612747.45748848 4561969.949448111, -13612734.76710209 4561971.641598261, -13612722.07683905 4561973.615723711, -13612709.16360075 4561976.295666693, -13612689.34862698 4561980.385627104, -13612659.06996659 4561985.321620884, -13612538.06560805 4562005.206290906, -13612508.56607497 4562010.283423718, -13612488.97394029 4562013.668324756, -13612458.24939896 4562016.629801525, -13612457.58186665 4562010.001585998, -13612455.68911953 4561991.24462847, -13612453.90828893 4561971.782735932, -13612447.34034412 4561915.370881629, -13612444.55746075 4561890.127227819, -13612441.32911357 4561864.742347707, -13612436.09717272 4561822.293073001, -13612434.20444911 4561788.587816828, -13612432.86882689 4561763.061641838, -13612430.53119338 4561737.253817131, -13612423.51784535 4561659.97199324, -13612421.29137759 4561634.305982187, -13612418.7308596 4561607.933934352, -13612417.95177186 4561600.037062312, -13612415.05763056 4561557.729869468, -13612412.05198856 4561529.242887767, -13612410.49371992 4561513.16671684, -13612409.6032071 4561503.012666661, -13612407.37647053 4561477.910986511, -13612400.69764435 4561403.028417151, -13612398.47100907 4561378.067675525, -13612397.80286663 4561371.157308755, -13612395.91063685 4561350.427673933, -13612395.35419088 4561343.658316277, -13612393.57311725 4561324.479582941, -13612388.45223565 4561267.366834573, -13612386.78230856 4561248.32922494, -13612384.44490643 4561223.933075069, -13612382.44080231 4561202.498227597, -13612379.9920654 4561181.48608713, -13612377.32022912 4561151.308600348, -13612376.65242924 4561142.42404045, -13612374.42596947 4561127.194342336, -13612424.85392915 4561119.297499428, -13612450.67957542 4561115.349133001, -13612536.17299339 4561102.657220115, -13612576.47097764 4561096.593547792, -13612627.00988912 4561089.119830658, -13612677.66049397 4561080.658421176, -13612729.75759459 4561072.056902992, -13612775.84394198 4561062.890755525, -13612829.83418029 4561054.570392478, -13612835.17732598 4561053.865625421, -13612880.70677458 4561046.532381284, -13612901.41270063 4561043.148151763, -13612963.63982093 4561033.136183424, -13612984.45682399 4561029.892767751, -13612996.2567676 4561027.777262427, -13613031.767827 4561021.854752512, -13613043.6788774 4561019.880741948, -13613077.29715759 4561013.675915006, -13613124.94199183 4561004.93313023, -13613178.4864965 4560995.908104054, -13613212.32759291 4560990.267338416, -13613271.54992226 4560981.665005207, -13613285.46452771 4560979.691156344, -13613389.32582804 4560961.500210078, -13613449.10449409 4560952.193073755, -13613491.62862987 4560945.706498956, -13613500.97908504 4560944.155146189, -13613508.3263175 4560942.322010394, -13613512.44512302 4560957.269354265, -13613517.89963611 4560981.101003526, -13613544.95053646 4561098.285710569, -13613553.96732801 4561137.48882294, -13613563.31827863 4561173.025024455, -13613591.37085276 4561279.494170676, -13613599.38584779 4561309.672339028, -13613600.83261845 4561315.172362396, -13613607.62339358 4561340.555782871, -13613627.99476523 4561416.707522701, -13613634.89681132 4561442.23214691, -13613641.13066876 4561466.488289025, -13613659.94356271 4561539.396862683, -13613666.28868148 4561563.793619493))"
421300,3856,3788,3108,49,0,340,9,0,282,8,274,68,61,0,0,0,0,7,0,0,0,15376.0,"POLYGON ((-13610687.60192473 4561402.46437894, -13610707.9732827 4561399.361479781, -13610726.6747386 4561396.541075688, -13610756.61968781 4561390.618326448, -13610768.97633258 4561388.36211718, -13610789.34745052 4561384.55441169, -13610802.70601855 4561382.580023256, -13610842.89222248 4561376.798327252, -13610856.36187434 4561374.964874236, -13610908.12540988 4561366.786061526, -13611063.75004376 4561342.812384847, -13611115.62494146 4561334.774131699, -13611147.57394617 4561329.415654573, -13611158.48335844 4561327.723023565, -13611243.08618417 4561312.492824227, -13611243.1972043 4561312.351850229, -13611275.25718777 4561307.133986823, -13611295.29490348 4561303.749948394, -13611355.40746237 4561293.737157501, -13611365.64875444 4561292.186077218, -13611375.55628528 4561290.634664192, -13611377.00327664 4561304.031900221, -13611378.11642116 4561317.146857835, -13611385.24115404 4561397.105597153, -13611387.68980063 4561423.899159816, -13611389.35965463 4561448.29591391, -13611392.2539811 4561490.038980502, -13611395.25958832 4561521.768591063, -13611397.59762333 4561546.306923619, -13611399.60094555 4561571.408940805, -13611405.72373931 4561646.715660009, -13611407.83877604 4561671.959493663, -13611410.51055807 4561696.215369736, -13611418.52553192 4561769.407732839, -13611421.30847156 4561793.805406498, -13611423.42361962 4561819.190297872, -13611429.76855129 4561895.345333279, -13611431.99537954 4561920.730197234, -13611435.77983683 4561971.641305259, -13611447.24570913 4562124.658973562, -13611451.14198679 4562175.712649255, -13611444.46315343 4562176.841051457, -13611424.98201739 4562180.225426813, -13611346.72415881 4562193.905822791, -13611320.67578503 4562198.559928929, -13611295.51755382 4562202.790798446, -13611220.04269683 4562215.342336142, -13611194.99606901 4562219.714554248, -13611169.50373627 4562223.240089327, -13611123.5286406 4562230.009966948, -13611093.25020584 4562234.804779918, -13611067.86907598 4562239.036219515, -13611042.82229345 4562243.266792776, -13610983.93435704 4562253.421544083, -13610967.68165565 4562255.395877946, -13610942.63455457 4562258.780793007, -13610929.83279145 4562263.716581008, -13610917.253937 4562265.267853709, -13610839.88650529 4562275.704261909, -13610814.17180517 4562279.371332307, -13610788.45723757 4562283.602336408, -13610751.27633834 4562289.949109144, -13610711.64688768 4562297.282595078, -13610686.15456429 4562302.218669932, -13610661.1079381 4562306.026776397, -13610630.94007982 4562310.539714585, -13610630.71739446 4562310.680957693, -13610586.18967264 4562318.014771343, -13610570.15968762 4562320.694389711, -13610561.25400726 4562319.283813789, -13610558.80523591 4562276.832620686, -13610551.79177489 4562149.90368607, -13610549.45417939 4562107.594191842, -13610549.45417868 4562098.145429954, -13610549.67689813 4562069.798095352, -13610549.89964634 4562060.490121593, -13610545.66935675 4562046.810131617, -13610527.30136865 4561996.180619738, -13610526.74486435 4561988.988052904, -13610525.07515199 4561966.564412623, -13610528.41501702 4561944.140952522, -13610532.86764817 4561920.871218891, -13610539.88053506 4561897.46047063, -13610540.88242278 4561878.421964045, -13610541.43931794 4561868.267981113, -13610537.20934203 4561838.934301685, -13610531.75469537 4561799.728417161, -13610527.74678828 4561760.382538406, -13610520.17745464 4561683.382061263, -13610541.2163471 4561680.138835113, -13610604.33480261 4561670.972310074, -13610625.48535611 4561668.010635089, -13610629.7156152 4561656.587479347, -13610628.82486864 4561645.446498333, -13610623.14788136 4561574.370268444, -13610621.25556807 4561550.678298063, -13610618.24941097 4561523.319888494, -13610609.23280769 4561441.527071833, -13610607.89681389 4561428.553110923, -13610606.56107873 4561414.309997127, -13610622.7024681 4561411.771554666, -13610671.34886015 4561404.72063728, -13610687.60192473 4561402.46437894))"
421400,1642,1583,1262,58,3,188,5,21,46,0,46,59,42,0,0,0,0,17,0,0,0,3186.0,"POLYGON ((-13610561.25400726 4562319.283813789, -13610534.53729063 4562323.51486279, -13610454.60979625 4562336.490222004, -13610428.00467264 4562340.862026802, -13610405.29559575 4562344.811009041, -13610337.50202854 4562356.516734873, -13610315.01563399 4562360.606858656, -13610304.66263156 4562362.158452446, -13610273.82696112 4562367.09465573, -13610263.58562606 4562368.786664713, -13610243.54840893 4562372.312612604, -13610183.76993387 4562383.031301027, -13610163.95484143 4562386.69843269, -13610139.79871331 4562390.506083905, -13610067.21805704 4562402.212103034, -13610043.17295876 4562406.161130903, -13609992.4117151 4562413.776933346, -13609977.49496296 4562416.033217939, -13609840.34909389 4562439.727230146, -13609789.80990701 4562448.612553915, -13609766.43317071 4562451.574416501, -13609761.75734407 4562452.702296912, -13609747.50890442 4562456.510312125, -13609717.89772424 4562460.036651783, -13609704.09390956 4562462.43414342, -13609677.93366071 4562463.562590037, -13609668.80557084 4562464.126326613, -13609658.45311844 4562463.139270534, -13609650.21532577 4562459.895349866, -13609656.1151479 4562472.588553506, -13609660.45664916 4562478.935409249, -13609664.7982454 4562482.179091647, -13609665.13209006 4562482.46090144, -13609671.36592861 4562485.422823189, -13609677.04316681 4562491.487478274, -13609682.3868153 4562498.821058351, -13609686.28300905 4562505.873089397, -13609689.62236059 4562514.476559236, -13609691.84908743 4562522.092429907, -13609698.52789511 4562536.196207325, -13609701.97876656 4562540.286228539, -13609705.87495495 4562543.529788248, -13609710.1052894 4562545.363132388, -13609710.99567879 4562545.786670256, -13609717.89753539 4562551.004805157, -13609719.78987477 4562554.812962894, -13609721.12614457 4562568.493151954, -13609716.45032635 4562566.518967122, -13609701.53340463 4562562.287621888, -13609689.73405845 4562558.056558771, -13609682.72083227 4562554.530684934, -13609680.82844604 4562553.966432991, -13609672.47906001 4562551.568768525, -13609657.33975631 4562552.979115461, -13609647.98894023 4562557.774563349, -13609633.18362831 4562564.262490494, -13609619.49134491 4562566.942216603, -13609610.80856631 4562567.224029219, -13609604.1288895 4562565.672513018, -13609598.7860213 4562563.416085882, -13609587.98788036 4562549.876456273, -13609571.51228113 4562524.490154029, -13609550.80692358 4562492.474722107, -13609547.24468323 4562481.897138844, -13609538.78467329 4562482.038239779, -13609538.11653073 4562482.178757569, -13609531.10360048 4562484.012579182, -13609523.75648308 4562487.115309513, -13609517.29978299 4562490.923019067, -13609515.18495144 4562492.192554326, -13609507.94919688 4562497.410905298, -13609492.36420834 4562500.796035942, -13609445.83255735 4562511.514801092, -13609430.35919837 4562515.040308584, -13609395.62760828 4562366.671053381, -13609371.36008276 4562262.729740934, -13609400.41437693 4562255.395611472, -13609346.31315189 4561944.986846151, -13609333.51143639 4561870.94742168, -13609395.62781966 4561869.959972493, -13609405.42394088 4561872.498562309, -13609420.78574585 4561876.729611613, -13609435.14628732 4561877.152377328, -13609436.81576849 4561877.293873716, -13609445.1647345 4561876.729278415, -13609470.32286596 4561872.216477494, -13609545.90885404 4561859.242011517, -13609571.1785629 4561854.86999994, -13609589.88047621 4561851.485850802, -13609604.46329462 4561849.229289094, -13609704.65033411 4561834.844197895, -13609738.04671169 4561830.049342777, -13609778.23281499 4561823.562295613, -13609899.12580116 4561804.382602334, -13609939.42337336 4561798.036537849, -13609983.1718567 4561790.843799551, -13609989.51738403 4561789.716017871, -13610114.52925997 4561769.831075001, -13610158.38860224 4561762.779772142, -13610198.57521763 4561755.728311647, -13610319.35699746 4561735.138744566, -13610321.13801842 4561734.856575804, -13610359.54327398 4561727.523279854, -13610373.01298407 4561723.574670433, -13610391.38044139 4561716.805532863, -13610396.16738363 4561715.113215554, -13610410.63891685 4561708.484795852, -13610438.80243149 4561696.356530754, -13610444.0348638 4561695.087546569, -13610451.71544928 4561694.241168837, -13610487.33786517 4561688.45947242, -13610520.17745464 4561683.382061263, -13610527.74678828 4561760.382538406, -13610531.75469537 4561799.728417161, -13610537.20934203 4561838.934301685, -13610541.43931794 4561868.267981113, -13610540.88242278 4561878.421964045, -13610539.88053506 4561897.46047063, -13610532.86764817 4561920.871218891, -13610528.41501702 4561944.140952522, -13610525.07515199 4561966.564412623, -13610526.74486435 4561988.988052904, -13610527.30136865 4561996.180619738, -13610545.66935675 4562046.810131617, -13610549.89964634 4562060.490121593, -13610549.67689813 4562069.798095352, -13610549.45417868 4562098.145429954, -13610549.45417939 4562107.594191842, -13610551.79177489 4562149.90368607, -13610558.80523591 4562276.832620686, -13610561.25400726 4562319.283813789))"
421500,3789,3604,2924,133,0,426,11,23,87,0,87,185,70,0,0,0,0,44,71,14,57,10920.0,"POLYGON ((-13612406.26326571 4562021.848236881, -13612350.60361482 4562030.87378865, -13612323.7756741 4562035.387050736, -13612300.06427251 4562039.194486821, -13612229.26550563 4562050.759210879, -13612205.66573103 4562054.70800967, -13612185.51675371 4562057.669340034, -13612125.07037019 4562066.695530528, -13612105.03304132 4562069.798282636, -13612076.31217019 4562074.45239776, -13611990.26229519 4562088.696572069, -13611961.65301999 4562093.491381392, -13611934.26871863 4562097.722492591, -13611852.11465567 4562110.696812907, -13611824.84138791 4562115.069214995, -13611799.68355611 4562119.300138498, -13611785.8800886 4562121.697478494, -13611785.76849741 4562121.838464704, -13611724.43134564 4562133.121106216, -13611707.06583792 4562136.364607596, -13611699.49577344 4562134.672580191, -13611674.2262028 4562138.90347928, -13611598.64018024 4562151.878403262, -13611573.48222065 4562156.25007263, -13611548.99219619 4562160.057759522, -13611475.52096542 4562171.763609733, -13611451.14198679 4562175.712649255, -13611447.24570913 4562124.658973562, -13611435.77983683 4561971.641305259, -13611431.99537954 4561920.730197234, -13611429.76855129 4561895.345333279, -13611423.42361962 4561819.190297872, -13611421.30847156 4561793.805406498, -13611418.52553192 4561769.407732839, -13611410.51055807 4561696.215369736, -13611407.83877604 4561671.959493663, -13611405.72373931 4561646.715660009, -13611399.60094555 4561571.408940805, -13611397.59762333 4561546.306923619, -13611395.25958832 4561521.768591063, -13611392.2539811 4561490.038980502, -13611389.35965463 4561448.29591391, -13611387.68980063 4561423.899159816, -13611385.24115404 4561397.105597153, -13611378.11642116 4561317.146857835, -13611377.00327664 4561304.031900221, -13611375.55628528 4561290.634664192, -13611424.87095816 4561282.173935174, -13611572.92577289 4561257.354037089, -13611591.96097656 4561254.252166108, -13611622.46255117 4561249.739462582, -13611672.55666251 4561241.559911994, -13611822.94916955 4561217.445653106, -13611873.15408267 4561209.407858905, -13611896.30889879 4561205.318258245, -13611966.10596119 4561193.331989703, -13611989.37182432 4561189.383175202, -13612016.42263916 4561184.729876432, -13612097.79718422 4561171.05096927, -13612124.95902483 4561166.538381005, -13612174.83039313 4561158.782545739, -13612183.73595366 4561157.513164215, -13612217.13145261 4561153.000564817, -13612290.71366252 4561141.155275799, -13612324.5545571 4561135.514480111, -13612359.73157869 4561129.873605266, -13612374.42596947 4561127.194342336, -13612376.65242924 4561142.42404045, -13612377.32022912 4561151.308600348, -13612379.9920654 4561181.48608713, -13612382.44080231 4561202.498227597, -13612384.44490643 4561223.933075069, -13612386.78230856 4561248.32922494, -13612388.45223565 4561267.366834573, -13612393.57311725 4561324.479582941, -13612395.35419088 4561343.658316277, -13612395.91063685 4561350.427673933, -13612397.80286663 4561371.157308755, -13612398.47100907 4561378.067675525, -13612400.69764435 4561403.028417151, -13612407.37647053 4561477.910986511, -13612409.6032071 4561503.012666661, -13612410.49371992 4561513.16671684, -13612412.05198856 4561529.242887767, -13612415.05763056 4561557.729869468, -13612417.95177186 4561600.037062312, -13612418.7308596 4561607.933934352, -13612421.29137759 4561634.305982187, -13612423.51784535 4561659.97199324, -13612430.53119338 4561737.253817131, -13612432.86882689 4561763.061641838, -13612434.20444911 4561788.587816828, -13612436.09717272 4561822.293073001, -13612441.32911357 4561864.742347707, -13612444.55746075 4561890.127227819, -13612447.34034412 4561915.370881629, -13612453.90828893 4561971.782735932, -13612455.68911953 4561991.24462847, -13612457.58186665 4562010.001585998, -13612458.24939896 4562016.629801525, -13612437.4325183 4562018.463070252, -13612431.19901794 4562018.886264756, -13612415.16890755 4562020.437846738, -13612406.26326571 4562021.848236881))"
421600,3698,3525,2695,117,0,518,23,0,172,0,172,173,97,0,0,11,0,28,37,23,14,14232.0,"POLYGON ((-13611530.62426775 4563059.877963974, -13611530.17887015 4563049.864259333, -13611524.83543487 4562988.087005139, -13611524.167589 4562980.61206783, -13611520.71674755 4562939.850687148, -13611514.8166771 4562891.191097601, -13611514.59447436 4562889.357700692, -13611511.81120164 4562853.392102185, -13611501.01332101 4562737.316358361, -13611498.56393897 4562709.954305203, -13611495.00180554 4562686.965345237, -13611494.00023289 4562681.323642176, -13611492.33009819 4562667.643203119, -13611490.10417225 4562635.486090726, -13611483.98110259 4562543.670750729, -13611477.97018633 4562480.768941155, -13611473.18327384 4562429.431696753, -13611469.95524726 4562391.352326525, -13611468.84202756 4562378.659324127, -13611455.48360037 4562226.342767496, -13611451.14198679 4562175.712649255, -13611475.52096542 4562171.763609733, -13611548.99219619 4562160.057759522, -13611573.48222065 4562156.25007263, -13611598.64018024 4562151.878403262, -13611674.2262028 4562138.90347928, -13611699.49577344 4562134.672580191, -13611707.06583792 4562136.364607596, -13611724.43134564 4562133.121106216, -13611785.76849741 4562121.838464704, -13611785.8800886 4562121.697478494, -13611799.68355611 4562119.300138498, -13611824.84138791 4562115.069214995, -13611852.11465567 4562110.696812907, -13611934.26871863 4562097.722492591, -13611961.65301999 4562093.491381392, -13611990.26229519 4562088.696572069, -13612076.31217019 4562074.45239776, -13612105.03304132 4562069.798282636, -13612125.07037019 4562066.695530528, -13612185.51675371 4562057.669340034, -13612205.66573103 4562054.70800967, -13612229.26550563 4562050.759210879, -13612300.06427251 4562039.194486821, -13612323.7756741 4562035.387050736, -13612350.60361482 4562030.87378865, -13612406.26326571 4562021.848236881, -13612415.16890755 4562020.437846738, -13612431.19901794 4562018.886264756, -13612437.4325183 4562018.463070252, -13612458.24939896 4562016.629801525, -13612459.25166705 4562030.873791485, -13612462.59125121 4562073.888149245, -13612463.70409261 4562088.273208109, -13612467.82293043 4562136.646549868, -13612472.49845474 4562189.392762662, -13612473.61168367 4562209.983035117, -13612479.84540791 4562282.050753736, -13612480.95852816 4562294.320824848, -13612486.85855402 4562320.976033603, -13612489.41921222 4562324.220188664, -13612489.08488792 4562328.309742086, -13612491.7564597 4562356.516578531, -13612499.77182555 4562441.137543062, -13612502.44350969 4562469.48596797, -13612504.22435204 4562499.244479343, -13612509.79022812 4562588.520523929, -13612511.68275283 4562618.279660504, -13612503.44507181 4562624.344190072, -13612498.54706218 4562627.588097134, -13612458.69460736 4562654.667326264, -13612445.4476858 4562663.834722583, -13612429.75173207 4562673.989391861, -13612401.58765286 4562692.465680147, -13612382.88629366 4562704.171879887, -13612367.30123927 4562714.185486764, -13612349.93575823 4562724.904929183, -13612297.72706578 4562757.485007684, -13612280.47206925 4562768.486098262, -13612260.21224588 4562781.038721154, -13612199.43197406 4562818.83715399, -13612179.28309294 4562831.530684823, -13612158.46591424 4562844.08344136, -13612096.0158456 4562881.882280227, -13612075.31073797 4562894.576518576, -13612016.19978256 4562930.541825174, -13611839.09066593 4563038.580622904, -13611820.16645863 4563050.287310542, -13611780.53674274 4563075.675187937, -13611757.15914728 4563091.472165871, -13611739.90503608 4563103.319908551, -13611688.36381236 4563141.401809184, -13611665.6545306 4563158.327394946, -13611649.73595818 4563174.829391963, -13611623.68734267 4563202.192327649, -13611602.3137544 4563224.3362758, -13611586.61776092 4563240.980168488, -13611577.15595128 4563228.426936737, -13611548.9916827 4563190.767862729, -13611545.20686117 4563185.689945659, -13611539.86373713 4563178.073678724, -13611535.41071418 4563171.303565346, -13611532.51666466 4563165.661701251, -13611530.73530733 4563160.442693789, -13611530.06768048 4563155.365101868, -13611530.17895381 4563138.862881621, -13611530.29038392 4563133.080325857, -13611532.18281816 4563087.099533316, -13611530.62426775 4563059.877963974))"
421700,3564,3213,2390,18,4,641,0,8,152,0,152,351,174,12,36,0,0,119,10,10,0,9594.0,"POLYGON ((-13609948.88564319 4559841.758381884, -13609919.05223383 4559847.116109316, -13609811.40619808 4559864.740905643, -13609696.07925429 4559910.707107365, -13609640.75307138 4559889.698461693, -13609490.91697856 4559901.54209274, -13609461.8629802 4559904.221535307, -13609374.69977218 4559912.258223634, -13609345.7567855 4559915.078341361, -13609317.1473787 4559916.911139201, -13609231.6539476 4559922.410603384, -13609203.15613496 4559924.384664075, -13609202.2657993 4559912.399604748, -13609199.59423862 4559876.443931963, -13609198.81497499 4559864.599927451, -13609197.59045366 4559843.450313353, -13609194.25065736 4559780.141082027, -13609193.13778577 4559759.132641013, -13609191.24505292 4559740.802311694, -13609185.79069746 4559685.953989252, -13609184.0096163 4559667.765360712, -13609183.67541037 4559663.39480463, -13609182.78499029 4559650.281760923, -13609182.56240291 4559645.91096484, -13609179.33378807 4559607.84156955, -13609178.22080962 4559595.57487086, -13609169.87188448 4559493.775535374, -13609166.75498043 4559455.848259325, -13609163.86053868 4559415.946602479, -13609155.51162891 4559296.524852335, -13609152.72831934 4559256.765362056, -13609179.44504999 4559251.971240789, -13609249.57653877 4559239.846326424, -13609259.70678384 4559238.295017828, -13609286.53459319 4559234.629754133, -13609314.36450774 4559230.117561024, -13609398.18784554 4559217.005802704, -13609426.1292944 4559212.634881158, -13609454.84968003 4559207.981915871, -13609541.23341192 4559194.588162532, -13609570.06535192 4559190.217119731, -13609597.00439626 4559185.564397181, -13609678.04524721 4559172.029047953, -13609705.09582912 4559167.517613066, -13609710.32769447 4559166.530636369, -13609726.35763829 4559164.133899116, -13609731.70113398 4559163.287901777, -13609763.76137642 4559157.36611391, -13609860.27508198 4559140.024265924, -13609879.08822202 4559136.781425891, -13609892.5579345 4559134.666547252, -13609910.36894198 4559131.988076115, -13609926.39928338 4559129.167883978, -13610027.92229887 4559111.40348905, -13610036.04850592 4559110.13457456, -13610061.87460096 4559106.186616722, -13610087.25582849 4559101.67524009, -13610163.39836806 4559088.703990643, -13610188.89058226 4559084.333350766, -13610213.49172549 4559080.526839746, -13610287.51944732 4559069.247123313, -13610312.23215832 4559065.581936496, -13610318.46640512 4559104.212654292, -13610337.16778321 4559220.530501458, -13610343.51327696 4559259.303327377, -13610347.29790297 4559284.963721522, -13610358.76406294 4559361.9461607, -13610362.66040534 4559387.747786704, -13610366.44489754 4559412.421478076, -13610377.79960695 4559486.444045045, -13610381.69581422 4559511.258950884, -13610385.92596615 4559537.061289754, -13610398.61654262 4559614.468677227, -13610402.8462405 4559640.411936588, -13610406.96515658 4559664.945316034, -13610419.65578621 4559738.828643994, -13610423.99690301 4559763.50354005, -13610374.46011604 4559771.258302527, -13610225.95985446 4559794.805146759, -13610176.53387944 4559802.842364979, -13610124.99293921 4559811.584256933, -13609970.48127978 4559838.091821436, -13609948.88564319 4559841.758381884))"
421800,2139,2063,1584,57,8,279,0,4,131,0,131,76,64,5,5,0,0,2,0,0,0,4014.0,"POLYGON ((-13610656.65463545 4563338.866531753, -13610631.83042069 4563342.251644036, -13610606.89510288 4563345.636964278, -13610588.86111634 4563348.17575466, -13610558.02591041 4563354.804843615, -13610533.53535212 4563360.164831159, -13610508.60012773 4563364.255273124, -13610433.79320249 4563376.52623729, -13610423.32932609 4563378.359816055, -13610408.85780428 4563380.193688749, -13610383.36582315 4563383.86067739, -13610307.00031507 4563395.003448615, -13610281.61937701 4563398.811799278, -13610262.91807616 4563401.068434231, -13610229.52192647 4563405.441205647, -13610207.03569398 4563407.698025121, -13610206.47915383 4563407.838911972, -13610188.33401311 4563408.262357055, -13610193.34330802 4563386.822842869, -13610196.68261833 4563372.435654912, -13610197.46191794 4563369.61470864, -13610208.59380133 4563322.505170132, -13610210.26380723 4563315.734942027, -13610213.04698752 4563300.92468485, -13610220.95040987 4563259.175153609, -13610226.85028202 4563228.427078934, -13610231.8596449 4563208.116002035, -13610236.53502804 4563181.740845448, -13610238.20483095 4563157.904122145, -13610238.31621018 4563148.454157673, -13610237.3146349 4563137.029236256, -13610236.53519955 4563133.644526869, -13610229.96750986 4563103.178873027, -13610223.73325325 4563095.280337207, -13610220.50498842 4563086.958890082, -13610216.05233965 4563077.649532177, -13610209.15054544 4563067.353412808, -13610186.33003041 4563033.220823044, -13610157.49822117 4562991.049129671, -13610140.24357883 4562965.80234099, -13610134.12135253 4562956.21150686, -13610116.08747269 4562927.720834543, -13610110.07639968 4562918.271053576, -13610087.9236186 4562919.258524322, -13610021.57696057 4562922.502411345, -13609999.53586615 4562923.772024221, -13609995.52837143 4562929.69562618, -13609989.85113116 4562935.055069189, -13609984.61887655 4562937.875912295, -13609983.61746052 4562938.01724475, -13609969.2572007 4562940.978802538, -13609924.61789563 4562947.184673148, -13609904.91427954 4562950.005768465, -13609905.80507478 4562955.647454818, -13609908.58798008 4562972.572267895, -13609909.58988597 4562978.35500118, -13609913.26309598 4562998.101388128, -13609916.93666468 4563022.924698041, -13609916.15770344 4563031.105582402, -13609914.26521486 4563036.888174679, -13609910.70322055 4563043.517254176, -13609907.58619059 4563047.325123766, -13609903.80144302 4563050.710653784, -13609898.3465479 4563054.51877622, -13609885.98989584 4563056.07010361, -13609869.8488071 4563056.352206607, -13609844.57906679 4563056.916182459, -13609829.10565797 4563057.480414548, -13609822.09291376 4563059.031943108, -13609812.07365654 4563064.673641739, -13609805.61762223 4563070.59774233, -13609799.27209187 4563083.291749864, -13609796.93433612 4563097.53709629, -13609798.93835157 4563121.091144733, -13609803.61380817 4563136.324351468, -13609812.8532512 4563157.480950454, -13609917.15938506 4563296.552135743, -13609940.87065049 4563328.147026221, -13609946.43647523 4563338.443238956, -13609948.77399636 4563345.636637928, -13609950.77817851 4563355.510355482, -13609951.0004936 4563362.562786386, -13609948.21773386 4563375.539028215, -13609941.42692232 4563383.155745116, -13609929.62725802 4563392.323481064, -13609909.14442708 4563403.607327695, -13609902.13138257 4563404.736202604, -13609898.68025932 4563404.45356657, -13609898.34642951 4563404.453767178, -13609895.11814159 4563401.491640946, -13609893.78262372 4563397.119584805, -13609893.78247274 4563389.784584327, -13609901.79736169 4563361.857417096, -13609902.46549476 4563351.701782038, -13609901.90869597 4563347.18835979, -13609897.90108481 4563340.841450675, -13609886.88068383 4563333.506779875, -13609858.82800048 4563317.568152684, -13609854.26394938 4563315.029583929, -13609829.21702248 4563299.655459866, -13609830.44183891 4563336.609970889, -13609831.22066968 4563357.202941504, -13609829.88523858 4563376.526276503, -13609828.32658934 4563386.399667106, -13609826.99100199 4563391.477520221, -13609825.54383802 4563400.363286887, -13609821.86981546 4563409.249608642, -13609815.97026524 4563419.264033691, -13609808.95675312 4563427.86801959, -13609801.49843677 4563433.791763658, -13609800.94191167 4563434.073929364, -13609785.91371606 4563443.242106103, -13609773.44611574 4563445.075641524, -13609755.96886564 4563440.421421877, -13609705.20737139 4563411.224119197, -13609704.98460485 4563411.083328514, -13609695.29980882 4563408.826415808, -13609681.49624125 4563409.954677903, -13609660.56808914 4563416.866204469, -13609646.43027084 4563422.790230809, -13609577.07842086 4563455.513410291, -13609572.06910666 4563458.334249264, -13609567.61646084 4563461.860893931, -13609565.8351499 4563466.23325674, -13609565.83523398 4563470.746870554, -13609580.08417376 4563507.137437419, -13609581.97666169 4563515.036268941, -13609580.97494032 4563525.192231618, -13609578.30312035 4563532.808579845, -13609568.39581076 4563544.515719294, -13609567.50489274 4563544.938790401, -13609557.15245462 4563551.427361269, -13609551.809154 4563553.543039157, -13609544.23929118 4563557.915458344, -13609538.67323037 4563563.980654052, -13609533.99797422 4563572.867007026, -13609531.77161387 4563588.664738474, -13609531.66020245 4563594.448089664, -13609532.32789022 4563602.628951772, -13609534.99945895 4563612.925373415, -13609514.6285042 4563619.695887169, -13609506.50203454 4563620.260117678, -13609498.15285753 4563621.106308392, -13609482.56843062 4563620.119405401, -13609470.21165281 4563617.721275488, -13609464.31206016 4563613.912627432, -13609460.63848733 4563607.84780893, -13609456.18575015 4563594.447903748, -13609453.06868723 4563574.982720765, -13609450.95354204 4563567.083753652, -13609448.17059377 4563562.429386505, -13609447.39108303 4563561.018703545, -13609442.38197795 4563557.49236427, -13609436.37043989 4563555.518033141, -13609430.69357236 4563555.517741363, -13609420.78596054 4563557.633391372, -13609411.32366526 4563567.225014866, -13609410.98988851 4563567.647962023, -13609406.8707883 4563578.508938394, -13609406.53683833 4563586.407744061, -13609408.42956229 4563610.24581636, -13609407.87259611 4563611.656094464, -13609405.53497563 4563618.84951416, -13609401.5274024 4563624.49181224, -13609395.07105158 4563628.017822593, -13609382.38055769 4563630.980125312, -13609379.70921372 4563630.275076327, -13609376.81457464 4563629.710683313, -13609360.11690596 4563623.504199916, -13609352.7694284 4563616.874983261, -13609347.42657526 4563609.399155156, -13609341.19242188 4563590.075383361, -13609336.51677721 4563583.304566881, -13609330.83987397 4563578.509098839, -13609309.80022779 4563567.788971401, -13609303.3438705 4563585.561823301, -13609295.2174532 4563600.795015421, -13609292.76863356 4563607.706620466, -13609291.76644086 4563616.310598274, -13609295.21741578 4563638.879240409, -13609296.21914255 4563650.304222294, -13609296.44204125 4563661.165189763, -13609295.32885686 4563675.411304127, -13609291.87780109 4563685.990522981, -13609285.42165109 4563696.710389064, -13609275.84808107 4563716.598573619, -13609269.72508216 4563731.55053529, -13609269.0571988 4563734.653294032, -13609267.94427016 4563741.706140905, -13609268.61202046 4563752.144000934, -13609268.38944198 4563768.36535381, -13609268.946254 4563780.072376982, -13609258.70445896 4563771.468378135, -13609248.68623224 4563759.902207493, -13609247.0161446 4563757.081010995, -13609229.42755806 4563727.318466538, -13609213.50919146 4563695.722721563, -13609207.49776793 4563674.423968955, -13609204.60345836 4563666.524910311, -13609203.37894974 4563664.268520665, -13609197.92418401 4563653.689305895, -13609192.69249723 4563646.072390277, -13609183.67531737 4563639.020015203, -13609177.66432226 4563636.76348896, -13609170.31691342 4563635.070582547, -13609163.41516492 4563634.929292631, -13609147.05117801 4563637.045424127, -13609132.35726898 4563642.405478249, -13609129.35174002 4563643.674774325, -13609121.67063098 4563648.893844173, -13609114.21216538 4563658.767409346, -13609109.42547358 4563668.217965342, -13609108.08934311 4563677.386217934, -13609107.19863044 4563697.133524653, -13609110.09306523 4563774.712818685, -13609111.8741975 4563788.676853891, -13609114.4348722 4563798.973816589, -13609117.1062988 4563805.885503195, -13609121.44793008 4563811.386704767, -13609128.68364775 4563817.169765817, -13609129.24027013 4563817.451704207, -13609150.05699625 4563829.01849594, -13609160.07581069 4563835.789032593, -13609166.30957569 4563842.559458689, -13609172.65476975 4563852.433215742, -13609167.53383812 4563858.498524995, -13609162.07947868 4563863.153243789, -13609155.40009668 4563866.256904849, -13609152.6171966 4563866.962228087, -13609083.48780891 4563884.594069281, -13609060.4446474 4563890.659280047, -13609062.89389234 4563903.636276895, -13609068.57090878 4563932.693892093, -13609071.57645887 4563942.42649826, -13609072.57828068 4563945.388850566, -13609077.0313431 4563953.992933098, -13609069.12769995 4563964.149215505, -13609045.63946348 4563994.89963262, -13609037.84686883 4564005.196415876, -13609030.05438787 4564016.903995904, -13609023.70917127 4564024.944648659, -13609016.69623938 4564032.843766938, -13609003.6718743 4564042.153319688, -13608985.52659295 4564053.861040272, -13608941.22142863 4564072.762599461, -13608915.95202774 4564080.238756172, -13608898.02970982 4564082.354600246, -13608882.77858669 4564082.354592114, -13608866.30351961 4564079.6746929, -13608841.47947138 4564070.646875339, -13608826.11694361 4564058.374916388, -13608817.32283282 4564049.20640685, -13608809.7532735 4564043.281857262, -13608801.40440013 4564037.921967347, -13608774.91040829 4564032.984773742, -13608748.74988503 4564030.586890738, -13608736.39367328 4564032.98483411, -13608725.48411322 4564038.062720676, -13608711.90315778 4564051.886420514, -13608702.88655284 4564063.734943652, -13608695.53937993 4564069.659713018, -13608693.86961463 4564070.506080117, -13608692.75621801 4564067.402589848, -13608688.30361538 4564061.901321941, -13608662.03224866 4564015.21161349, -13608760.10493302 4563889.389694093, -13608783.14790286 4563845.239479946, -13608776.46857251 4563833.955459347, -13608756.32015867 4563800.101980664, -13608749.75197804 4563788.81774527, -13608751.31064142 4563651.432493387, -13608735.16910042 4563615.464361097, -13608707.78457311 4563554.530596052, -13608694.092517 4563520.819324617, -13608695.20551284 4563508.971030249, -13608695.53939264 4563500.50824788, -13608695.09392231 4563491.480833326, -13608693.09016663 4563478.927760071, -13608686.85652879 4563456.218925646, -13608675.05675468 4563445.075778405, -13608602.47622008 4563380.052492975, -13608577.54063433 4563358.472145407, -13608549.37720262 4563332.519133221, -13608464.8854572 4563254.661729641, -13608436.83310197 4563228.850295819, -13608426.59130655 4563170.174758101, -13608425.03294335 4563160.583702972, -13608431.93495608 4562990.485201095, -13608434.1615266 4562939.145517942, -13608434.49502409 4562930.683200491, -13608433.60450261 4562910.795962545, -13608431.15568662 4562851.417720703, -13608430.3762614 4562831.671681242, -13608424.47669542 4562790.347195824, -13608406.99929842 4562666.514347705, -13608405.77484372 4562657.488184359, -13608401.2104229 4562625.331541951, -13608466.10981085 4562633.51196277, -13608503.84745752 4562638.306978486, -13608661.14185053 4562658.19309641, -13608705.89190696 4562663.975913215, -13608721.9223855 4562679.913336839, -13608848.38120821 4562632.524614701, -13608860.51513219 4562628.152151891, -13608969.49657888 4562587.674175508, -13609286.86847774 4562537.606113752, -13609430.35919837 4562515.040308584, -13609445.83255735 4562511.514801092, -13609492.36420834 4562500.796035942, -13609507.94919688 4562497.410905298, -13609515.18495144 4562492.192554326, -13609517.29978299 4562490.923019067, -13609523.75648308 4562487.115309513, -13609531.10360048 4562484.012579182, -13609538.11653073 4562482.178757569, -13609538.78467329 4562482.038239779, -13609547.24468323 4562481.897138844, -13609550.80692358 4562492.474722107, -13609571.51228113 4562524.490154029, -13609587.98788036 4562549.876456273, -13609598.7860213 4562563.416085882, -13609604.1288895 4562565.672513018, -13609610.80856631 4562567.224029219, -13609619.49134491 4562566.942216603, -13609633.18362831 4562564.262490494, -13609647.98894023 4562557.774563349, -13609657.33975631 4562552.979115461, -13609672.47906001 4562551.568768525, -13609680.82844604 4562553.966432991, -13609682.72083227 4562554.530684934, -13609689.73405845 4562558.056558771, -13609701.53340463 4562562.287621888, -13609716.45032635 4562566.518967122, -13609721.12614457 4562568.493151954, -13609719.78987477 4562554.812962894, -13609717.89753539 4562551.004805157, -13609710.99567879 4562545.786670256, -13609710.1052894 4562545.363132388, -13609705.87495495 4562543.529788248, -13609701.97876656 4562540.286228539, -13609698.52789511 4562536.196207325, -13609691.84908743 4562522.092429907, -13609689.62236059 4562514.476559236, -13609686.28300905 4562505.873089397, -13609682.3868153 4562498.821058351, -13609677.04316681 4562491.487478274, -13609671.36592861 4562485.422823189, -13609665.13209006 4562482.46090144, -13609664.7982454 4562482.179091647, -13609660.45664916 4562478.935409249, -13609656.1151479 4562472.588553506, -13609650.21532577 4562459.895349866, -13609658.45311844 4562463.139270534, -13609668.80557084 4562464.126326613, -13609677.93366071 4562463.562590037, -13609704.09390956 4562462.43414342, -13609717.89772424 4562460.036651783, -13609747.50890442 4562456.510312125, -13609761.75734407 4562452.702296912, -13609766.43317071 4562451.574416501, -13609789.80990701 4562448.612553915, -13609840.34909389 4562439.727230146, -13609977.49496296 4562416.033217939, -13609992.4117151 4562413.776933346, -13610043.17295876 4562406.161130903, -13610067.21805704 4562402.212103034, -13610139.79871331 4562390.506083905, -13610163.95484143 4562386.69843269, -13610183.76993387 4562383.031301027, -13610243.54840893 4562372.312612604, -13610263.58562606 4562368.786664713, -13610273.82696112 4562367.09465573, -13610304.66263156 4562362.158452446, -13610315.01563399 4562360.606858656, -13610337.50202854 4562356.516734873, -13610405.29559575 4562344.811009041, -13610428.00467264 4562340.862026802, -13610454.60979625 4562336.490222004, -13610534.53729063 4562323.51486279, -13610561.25400726 4562319.283813789, -13610566.26349326 4562369.915103717, -13610580.62363691 4562513.065880669, -13610581.51448351 4562522.233185009, -13610586.41257295 4562573.147712634, -13610590.75364414 4562624.203378177, -13610598.87983941 4562716.58316166, -13610602.66476713 4562778.076390421, -13610605.89297764 4562829.415420217, -13610610.79107361 4562867.778677051, -13610621.03268339 4562946.197781906, -13610623.81579171 4562975.393240406, -13610624.26093116 4562983.291497011, -13610627.04417863 4563022.219804123, -13610627.82316137 4563032.51588053, -13610630.38352547 4563063.827531825, -13610631.27420146 4563074.264682058, -13610633.50049749 4563102.191299092, -13610635.83809683 4563130.964357835, -13610640.95877728 4563186.113322583, -13610643.63063228 4563214.181045475, -13610646.30225924 4563239.005286255, -13610652.64756505 4563297.680924075, -13610654.20563028 4563313.760073553, -13610656.65463545 4563338.866531753))"
421900,4020,3658,2320,262,0,681,9,19,367,21,346,362,251,23,6,0,0,69,13,0,13,14528.0,"POLYGON ((-13611520.71674755 4562939.850687148, -13611524.167589 4562980.61206783, -13611524.83543487 4562988.087005139, -13611530.17887015 4563049.864259333, -13611530.62426775 4563059.877963974, -13611532.18281816 4563087.099533316, -13611530.29038392 4563133.080325857, -13611530.17895381 4563138.862881621, -13611530.06768048 4563155.365101868, -13611530.73530733 4563160.442693789, -13611532.51666466 4563165.661701251, -13611535.41071418 4563171.303565346, -13611539.86373713 4563178.073678724, -13611531.62604517 4563183.715576876, -13611518.71312839 4563191.049701598, -13611454.37052202 4563228.00391691, -13611432.99678456 4563240.415750125, -13611417.18976284 4563249.30145687, -13611369.99021873 4563276.241662055, -13611354.2942197 4563285.268325346, -13611339.15459891 4563279.344582308, -13611334.47933857 4563277.511150883, -13611319.00573952 4563269.18899241, -13611305.53637289 4563259.45694751, -13611297.63265698 4563251.55844856, -13611297.18704929 4563251.135069357, -13611287.39109909 4563236.466344205, -13611266.35147323 4563239.428380001, -13611205.12617831 4563248.596232588, -13611203.34496094 4563249.019889306, -13611182.75091799 4563254.379307752, -13611168.72468998 4563256.495163595, -13611152.47172229 4563258.892716034, -13611061.85806122 4563273.13838118, -13611031.69049206 4563277.934344484, -13611006.08686598 4563282.024708509, -13610929.16482626 4563294.436425078, -13610903.67281164 4563298.668146069, -13610892.76349688 4563300.078790375, -13610879.18267362 4563302.335061966, -13610805.82315032 4563315.170365407, -13610781.44420419 4563319.543281057, -13610756.39744478 4563323.351401076, -13610681.5903488 4563334.917044863, -13610656.65463545 4563338.866531753, -13610654.20563028 4563313.760073553, -13610652.64756505 4563297.680924075, -13610646.30225924 4563239.005286255, -13610643.63063228 4563214.181045475, -13610640.95877728 4563186.113322583, -13610635.83809683 4563130.964357835, -13610633.50049749 4563102.191299092, -13610631.27420146 4563074.264682058, -13610630.38352547 4563063.827531825, -13610627.82316137 4563032.51588053, -13610627.04417863 4563022.219804123, -13610624.26093116 4562983.291497011, -13610623.81579171 4562975.393240406, -13610621.03268339 4562946.197781906, -13610610.79107361 4562867.778677051, -13610605.89297764 4562829.415420217, -13610602.66476713 4562778.076390421, -13610598.87983941 4562716.58316166, -13610590.75364414 4562624.203378177, -13610586.41257295 4562573.147712634, -13610581.51448351 4562522.233185009, -13610580.62363691 4562513.065880669, -13610566.26349326 4562369.915103717, -13610561.25400726 4562319.283813789, -13610570.15968762 4562320.694389711, -13610586.18967264 4562318.014771343, -13610630.71739446 4562310.680957693, -13610630.94007982 4562310.539714585, -13610661.1079381 4562306.026776397, -13610686.15456429 4562302.218669932, -13610711.64688768 4562297.282595078, -13610751.27633834 4562289.949109144, -13610788.45723757 4562283.602336408, -13610814.17180517 4562279.371332307, -13610839.88650529 4562275.704261909, -13610917.253937 4562265.267853709, -13610929.83279145 4562263.716581008, -13610942.63455457 4562258.780793007, -13610967.68165565 4562255.395877946, -13610983.93435704 4562253.421544083, -13611042.82229345 4562243.266792776, -13611067.86907598 4562239.036219515, -13611093.25020584 4562234.804779918, -13611123.5286406 4562230.009966948, -13611169.50373627 4562223.240089327, -13611194.99606901 4562219.714554248, -13611220.04269683 4562215.342336142, -13611295.51755382 4562202.790798446, -13611320.67578503 4562198.559928929, -13611346.72415881 4562193.905822791, -13611424.98201739 4562180.225426813, -13611444.46315343 4562176.841051457, -13611451.14198679 4562175.712649255, -13611455.48360037 4562226.342767496, -13611468.84202756 4562378.659324127, -13611469.95524726 4562391.352326525, -13611473.18327384 4562429.431696753, -13611477.97018633 4562480.768941155, -13611483.98110259 4562543.670750729, -13611490.10417225 4562635.486090726, -13611492.33009819 4562667.643203119, -13611494.00023289 4562681.323642176, -13611495.00180554 4562686.965345237, -13611498.56393897 4562709.954305203, -13611501.01332101 4562737.316358361, -13611511.81120164 4562853.392102185, -13611514.59447436 4562889.357700692, -13611514.8166771 4562891.191097601, -13611520.71674755 4562939.850687148))"
422000,2071,1930,1400,253,0,115,0,12,150,0,150,141,72,0,2,0,0,10,57,8,49,3512.0,"POLYGON ((-13611795.11944773 4563905.046774413, -13611825.39837292 4564078.405186669, -13611828.40386829 4564093.356998825, -13611830.51882293 4564104.924206147, -13611852.78308043 4564219.181648995, -13611856.79060031 4564243.020597585, -13611858.4601793 4564261.076245035, -13611859.12789165 4564276.733844994, -13611858.45994028 4564301.137272291, -13611857.56943204 4564310.447218009, -13611853.89593376 4564331.042228204, -13611850.66756126 4564344.302207431, -13611845.76978531 4564357.279747367, -13611823.50585891 4564401.009107183, -13611818.94166991 4564414.973918154, -13611817.04940619 4564427.105299273, -13611817.38314621 4564436.274413311, -13611818.38499101 4564443.327309336, -13611822.05837609 4564461.665510694, -13611827.51347911 4564472.527373451, -13611835.63973402 4564487.198059884, -13611837.75466401 4564490.583753213, -13611854.78650455 4564517.94996749, -13611869.81472758 4564543.905796277, -13611880.27882607 4564561.961702557, -13611890.51993196 4564576.209523816, -13611919.01796572 4564615.707211885, -13611921.46722842 4564618.669863291, -13611926.9215209 4564625.299775224, -13611928.59155777 4564634.892524585, -13611939.61193166 4564643.779280095, -13611950.18743675 4564648.293198295, -13611950.52130279 4564648.293504033, -13611961.87580225 4564651.678926245, -13611987.1452264 4564656.898546244, -13612023.4356616 4564661.835791175, -13612041.24676712 4564664.374720567, -13612047.92582326 4564665.78537543, -13612050.48640636 4564666.208601784, -13612058.056024 4564667.760613102, -13612060.72776201 4564668.324872291, -13612109.7083487 4564675.236883793, -13612121.50786221 4564677.071102507, -13612174.27377934 4564685.111807032, -13612190.74862457 4564688.355870883, -13612211.45418432 4564696.820226226, -13612224.03346264 4564705.142665798, -13612233.3840109 4564713.46584304, -13612247.5216659 4564729.124256151, -13612284.59121389 4564770.456929512, -13612296.7251015 4564785.833237959, -13612301.73406241 4564792.180981292, -13612309.19250288 4564803.043557917, -13612329.45295915 4564836.899427813, -13612329.89822227 4564837.6048907, -13612333.12654553 4564849.031526682, -13612333.57173657 4564857.918645073, -13612333.01488265 4564862.997266721, -13612330.23185732 4564873.294941859, -13612318.76621651 4564916.885601228, -13612318.43200556 4564918.860356849, -13612316.09445874 4564934.659870648, -13612316.09464192 4564958.92413003, -13612316.76237633 4564970.068478721, -13612317.87567879 4564986.855976363, -13612324.88901642 4565045.964380399, -13612325.33400195 4565061.341044319, -13612323.99812734 4565075.871469585, -13612322.21728579 4565097.455454894, -13612319.32263286 4565110.857020257, -13612304.62874117 4565141.328655642, -13612288.48731982 4565175.46815272, -13612287.0401598 4565179.841426405, -13612286.48360933 4565184.355479588, -13612286.81726486 4565189.434281494, -13612289.60076651 4565198.322047147, -13612291.04787494 4565200.861059224, -13612307.07740698 4565219.482546632, -13612308.41325154 4565225.830739823, -13612307.41170963 4565228.934419529, -13612306.18710063 4565231.332612174, -13612302.29071408 4565239.091913581, -13612286.70603429 4565256.86693212, -13612304.62836472 4565265.472521205, -13612358.39622142 4565291.571230498, -13612359.39754926 4565292.135691478, -13612377.32041968 4565296.226783102, -13612409.15780046 4565287.903478823, -13612427.19156017 4565283.24804449, -13612456.57988508 4565273.372850287, -13612468.15706012 4565267.729709174, -13612476.61725275 4565261.381617206, -13612481.07027267 4565255.174238012, -13612487.30417251 4565243.042105841, -13612491.20003825 4565233.025538214, -13612498.10181152 4565215.81490635, -13612506.78503089 4565196.769961075, -13612512.4622933 4565196.911039895, -13612522.59201966 4565196.346664409, -13612530.16202952 4565195.077080672, -13612563.11249192 4565180.546574405, -13612654.17171316 4565140.764037383, -13612727.75404238 4565105.3549628, -13612750.79736589 4565094.492498638, -13612775.62153204 4565081.93752073, -13612782.30062782 4565078.834018867, -13612787.53245741 4565097.032214527, -13612790.98376416 4565108.881815272, -13612800.33423847 4565131.594591427, -13612803.89628208 4565141.328660132, -13612804.67592434 4565143.021380702, -13612807.56994055 4565149.651503879, -13612808.57204677 4565151.90894133, -13612811.8004582 4565158.3980275, -13612815.91891638 4565165.028416567, -13612816.58706866 4565165.875201406, -13612813.8040644 4565166.580451742, -13612774.50819991 4565178.007022171, -13612701.70503134 4565199.45044967, -13612642.03774139 4565249.672649398, -13612601.51779058 4565284.094321761, -13612556.09960017 4565310.193164523, -13612550.86752321 4565313.296877365, -13612479.0661879 4565354.63137399, -13612415.50261572 4565369.58565593, -13612366.63334231 4565381.294526915, -13612353.38656677 4565384.25723561, -13612313.97974674 4565393.70971866, -13612300.9552711 4565396.954448154, -13612175.49776178 4565396.953951503, -13612133.97601666 4565396.954227906, -13611922.46904573 4565538.171567612, -13611945.51199623 4565655.266767846, -13611966.99668663 4565763.756771185, -13611935.82738517 4565774.620236663, -13611931.15158433 4565776.172299738, -13611889.29569317 4565790.562533205, -13611763.83854339 4565834.015285427, -13611722.09392377 4565848.546546106, -13611698.60522106 4565864.629898306, -13611694.59755277 4565867.310302187, -13611612.444172 4565924.025662479, -13611599.64242083 4565933.055224724, -13611586.39510369 4565945.61121955, -13611584.50280359 4565947.445233717, -13611567.80512688 4565963.105382097, -13611555.11434424 4565975.379616021, -13611509.25064649 4566010.227394289, -13611499.45454173 4566017.70510784, -13611488.10039891 4566021.232136832, -13611482.088911 4566023.207324406, -13611473.6285801 4566025.887777998, -13611433.99898076 4566038.303195045, -13611276.81591543 4566088.106131768, -13611271.69489129 4566089.799221536, -13611217.92771574 4566108.422569849, -13611186.42440627 4566119.286080484, -13611154.36439792 4566130.431815007, -13611193.88287735 4566065.955609518, -13611213.92050437 4566033.506633618, -13611220.59944313 4566022.501682103, -13611232.28807838 4566003.596661278, -13611225.94294935 4565987.653894272, -13611221.04451252 4565975.238689329, -13611188.87319191 4565964.939572868, -13611092.58196074 4565934.465719971, -13611060.52204654 4565924.307881967, -13611064.08434821 4565921.768405583, -13611066.75587298 4565918.664605285, -13611069.65019714 4565913.585600931, -13611080.11412766 4565901.4524709, -13611084.90122663 4565895.950034903, -13611088.35187031 4565889.601689698, -13611089.7988613 4565884.522768313, -13611091.58033612 4565861.667117825, -13611092.02535552 4565843.891284771, -13611094.91984729 4565803.964999135, -13611097.47988321 4565770.105489451, -13611100.15165409 4565728.628239751, -13611102.26709067 4565698.295887193, -13611108.38929112 4565622.677347437, -13611109.0575037 4565604.478537405, -13611110.17063364 4565580.071633115, -13611109.83633609 4565563.001377588, -13611102.93472666 4565552.138666151, -13611101.37635003 4565550.163273198, -13611098.25906317 4565546.354384426, -13611090.91243186 4565539.300626368, -13611084.90119425 4565535.491321319, -13611068.42574044 4565529.566275952, -13611066.53326937 4565528.860785631, -13611053.8429794 4565525.051627759, -13611046.60697115 4565528.155485595, -13611037.36738273 4565530.553542401, -13611029.57530426 4565531.823186629, -13611023.00734379 4565531.823053058, -13611022.45065806 4565531.823254283, -13611014.21338499 4565530.412728036, -13611005.53022549 4565527.873211278, -13610998.51729884 4565523.922666249, -13610995.0659449 4565521.383656701, -13610991.2812882 4565516.869150552, -13610988.49853912 4565511.084848448, -13610987.05121592 4565504.736583984, -13610986.38321115 4565497.82341821, -13610986.82850791 4565492.744832956, -13610988.27570616 4565486.396456547, -13611010.42824953 4565453.24363575, -13611030.79977854 4565423.053322723, -13611056.29199142 4565389.47712448, -13611056.8485074 4565388.912757963, -13611078.55602732 4565363.095835653, -13611112.39696738 4565325.852437726, -13611138.22315258 4565296.226922566, -13611144.56838807 4565289.173272189, -13611166.163987 4565265.895946169, -13611161.71137643 4565256.867134775, -13611161.0432658 4565255.738731314, -13611142.89869742 4565228.229125105, -13611136.88722314 4565219.200687214, -13611126.42342655 4565205.798590916, -13611095.2539544 4565166.016339058, -13611084.90084038 4565152.755317466, -13611068.75973673 4565130.465940783, -13611043.37853051 4565095.197833408, -13611036.92249872 4565081.090936223, -13611035.58666899 4565076.012283196, -13611032.35820089 4565055.274901705, -13611027.79402319 4565025.791430018, -13611025.67885396 4565012.954013976, -13611024.45446502 4565000.962961139, -13611020.55832281 4564960.193520165, -13611015.99419573 4564946.792246268, -13611006.97733037 4564930.992439278, -13611003.6380337 4564925.067345592, -13610994.95502487 4564911.101626532, -13610983.60004838 4564893.608797983, -13610982.04167032 4564891.210695945, -13610977.25526214 4564885.426998359, -13610965.56640968 4564865.677319583, -13610959.88907542 4564854.251006433, -13610953.98940599 4564838.169145466, -13610953.54411674 4564837.040810286, -13610949.42543992 4564816.585803533, -13610948.42338668 4564802.619969616, -13610949.64802411 4564782.870748732, -13610950.09335682 4564780.049600054, -13610950.98369157 4564775.252923818, -13610960.22288942 4564742.948878004, -13610964.4533762 4564720.80155917, -13610965.90020809 4564709.374800694, -13610965.9005779 4564690.189973912, -13610965.23278563 4564683.842040736, -13610963.33989365 4564676.929505209, -13610962.11575632 4564673.685032655, -13610960.89105003 4564670.440556486, -13610943.63640054 4564645.613284843, -13610892.42977794 4564601.31869212, -13610884.85981197 4564595.534938768, -13610877.95796242 4564589.046431881, -13610873.8393322 4564582.698271669, -13610870.49942151 4564573.811419888, -13610870.16556137 4564567.463320157, -13610870.6107562 4564559.846087225, -13610872.61463635 4564549.689448064, -13610875.50904945 4564524.861942634, -13610876.51075389 4564508.357731336, -13610876.39942804 4564496.9315342, -13610875.28620981 4564488.608667337, -13610872.05826392 4564476.477124282, -13610860.4809343 4564451.650253259, -13610815.06241472 4564373.078603865, -13610809.94199403 4564365.461137774, -13610805.37772713 4564360.383105327, -13610782.22328801 4564339.788082181, -13610799.47802015 4564324.835699535, -13610851.46418704 4564280.260588078, -13610868.82985527 4564265.449214344, -13610885.75041103 4564252.330635531, -13610908.12547429 4564235.262223124, -13610934.06311206 4564208.6023889, -13610949.53628096 4564192.944816694, -13610970.35323592 4564178.979799934, -13610993.28512865 4564163.745294189, -13611031.5790961 4564133.840875493, -13611051.72763409 4564118.183386483, -13611163.71498515 4564024.944595098, -13611284.27434803 4563929.872641656, -13611288.50416108 4563932.834894214, -13611291.73248532 4563934.104485886, -13611294.73797345 4563935.091433361, -13611301.9738901 4563935.514821028, -13611307.98516726 4563934.809597975, -13611313.66272775 4563932.693836341, -13611319.33962285 4563926.628336001, -13611321.00945099 4563921.268315424, -13611322.01158832 4563915.908217965, -13611320.78689181 4563907.303515304, -13611316.66802985 4563900.251124432, -13611313.21713383 4563897.712047029, -13611327.24346635 4563884.170641912, -13611337.37361765 4563877.964394427, -13611351.95655883 4563870.065283168, -13611368.98808589 4563862.307174263, -13611405.27829835 4563849.471383532, -13611418.41417989 4563847.073525559, -13611567.91612142 4563788.535797406, -13611586.50665491 4563780.918850052, -13611612.66680739 4563770.339756237, -13611625.69128844 4563764.133561763, -13611635.15299234 4563758.209635718, -13611640.38496937 4563752.990132222, -13611655.97000625 4563738.038995033, -13611678.45664326 4563739.026100959, -13611690.70179135 4563739.59008739, -13611705.06171074 4563738.743765153, -13611715.85999143 4563736.486947433, -13611738.56922415 4563733.806890437, -13611745.91596255 4563733.806908741, -13611746.13875963 4563733.948232275, -13611760.6105383 4563736.910486984, -13611767.28950323 4563731.832632751, -13611768.95936568 4563741.706054825, -13611772.85516507 4563766.390338561, -13611789.55359532 4563870.34731641, -13611795.11944773 4563905.046774413))"
422100,2754,2261,1405,347,34,342,0,6,127,1,126,493,97,0,80,0,0,316,0,0,0,5370.0,"POLYGON ((-13610789.90411306 4565893.551760337, -13610771.75936367 4565907.801241386, -13610751.49929033 4565923.743762345, -13610744.70865286 4565927.411795381, -13610739.03131369 4565930.656595805, -13610727.3424976 4565936.300127738, -13610724.22570136 4565936.582235256, -13610716.98991916 4565937.569407275, -13610711.42417688 4565938.275069918, -13610708.64132446 4565938.69828116, -13610695.95045029 4565938.556917259, -13610695.06036824 4565938.415996184, -13610689.60545564 4565937.992994582, -13610678.91860673 4565937.851979769, -13610661.10766379 4565936.441058701, -13610632.05304011 4565934.324460012, -13610577.84072301 4565927.552638171, -13610575.83713091 4565926.988630923, -13610547.89600081 4565920.216586232, -13610537.43197768 4565917.67680348, -13610533.09016167 4565915.842892362, -13610518.28454236 4565909.917372498, -13610502.14328533 4565901.452714184, -13610491.1225553 4565893.834215332, -13610488.11693115 4565891.85865776, -13610478.76657305 4565882.829739156, -13610474.42500612 4565874.505931213, -13610471.19645464 4565869.426719557, -13610463.96084882 4565861.10289919, -13610459.06289783 4565856.588395479, -13610454.94423112 4565853.625566321, -13610444.14587483 4565846.289189542, -13610437.13269531 4565843.749752059, -13610420.99147877 4565839.799653742, -13610415.31449985 4565839.79989522, -13610398.39380122 4565838.388720329, -13610381.80683156 4565841.351745927, -13610375.01657791 4565841.915913223, -13610369.22779398 4565841.351629428, -13610360.21106046 4565835.567357128, -13610358.3188433 4565833.451254126, -13610352.97556742 4565827.243487365, -13610335.16445551 4565802.836628743, -13610266.25722072 4565698.013840902, -13610226.07101965 4565636.785552172, -13610222.39755809 4565628.46141659, -13610203.3617755 4565583.175256227, -13610196.12642879 4565568.503689932, -13610187.22065421 4565551.856291251, -13610184.437603 4565548.046921622, -13610173.97344602 4565539.72383277, -13610156.38495853 4565529.989217473, -13610141.02298493 4565524.769605548, -13610134.67756855 4565523.499865144, -13610123.65715011 4565522.794325045, -13610091.37428674 4565517.997441933, -13610079.01780519 4565514.752771568, -13610075.23302776 4565513.483332768, -13610067.21842909 4565507.698946888, -13610064.5467815 4565505.159539261, -13610060.98437589 4565498.670165711, -13610059.31448539 4565490.487898163, -13610059.8709289 4565468.197442244, -13610058.86931 4565453.525745242, -13610057.86758102 4565441.25205317, -13610047.84872158 4565318.657801177, -13610045.28802753 4565305.961047038, -13610043.61819481 4565300.882363243, -13610038.83167459 4565292.700054572, -13610035.38057126 4565286.774701307, -13610026.92035525 4565276.617231091, -13610014.11864608 4565264.344247437, -13610010.89053691 4565262.509941516, -13610007.32851097 4565260.535085431, -13609999.20189932 4565257.854462859, -13610002.09634597 4565254.751192423, -13610040.61268539 4565207.35069176, -13610085.25192304 4565156.705595962, -13610099.72374776 4565140.482080722, -13610106.6252467 4565134.133919156, -13610139.01904859 4565095.056706218, -13610130.44774714 4565084.759017561, -13610113.63858115 4565067.406983688, -13610055.08439084 4565006.605569213, -13610035.26926398 4564988.407447834, -13610008.21875201 4564963.579460915, -13610029.48068387 4564946.791886639, -13610093.37835521 4564896.712589419, -13610109.29714912 4564884.298287855, -13610111.85726425 4564882.464316228, -13610114.30659552 4564879.361019317, -13610135.34575295 4564861.445610817, -13610198.46405241 4564808.26287441, -13610219.61462223 4564790.488472906, -13610237.09200589 4564775.676048827, -13610289.63443936 4564731.522233068, -13610307.2227512 4564716.851397641, -13610320.69244448 4564707.964225736, -13610328.93013756 4564701.616469663, -13610392.93925267 4564653.512929507, -13610414.31235587 4564637.572687419, -13610420.65738988 4564631.788908834, -13610439.80478057 4564614.861261716, -13610446.26091796 4564609.218531126, -13610547.22796798 4564528.671006581, -13610607.45162833 4564481.414627401, -13610782.22328801 4564339.788082181, -13610805.37772713 4564360.383105327, -13610809.94199403 4564365.461137774, -13610815.06241472 4564373.078603865, -13610860.4809343 4564451.650253259, -13610872.05826392 4564476.477124282, -13610875.28620981 4564488.608667337, -13610876.39942804 4564496.9315342, -13610876.51075389 4564508.357731336, -13610875.50904945 4564524.861942634, -13610872.61463635 4564549.689448064, -13610870.6107562 4564559.846087225, -13610870.16556137 4564567.463320157, -13610870.49942151 4564573.811419888, -13610873.8393322 4564582.698271669, -13610877.95796242 4564589.046431881, -13610884.85981197 4564595.534938768, -13610892.42977794 4564601.31869212, -13610943.63640054 4564645.613284843, -13610960.89105003 4564670.440556486, -13610962.11575632 4564673.685032655, -13610963.33989365 4564676.929505209, -13610965.23278563 4564683.842040736, -13610965.9005779 4564690.189973912, -13610965.90020809 4564709.374800694, -13610964.4533762 4564720.80155917, -13610960.22288942 4564742.948878004, -13610950.98369157 4564775.252923818, -13610950.09335682 4564780.049600054, -13610949.64802411 4564782.870748732, -13610948.42338668 4564802.619969616, -13610949.42543992 4564816.585803533, -13610953.54411674 4564837.040810286, -13610953.98940599 4564838.169145466, -13610959.88907542 4564854.251006433, -13610965.56640968 4564865.677319583, -13610977.25526214 4564885.426998359, -13610982.04167032 4564891.210695945, -13610983.60004838 4564893.608797983, -13610994.95502487 4564911.101626532, -13611003.6380337 4564925.067345592, -13611006.97733037 4564930.992439278, -13611015.99419573 4564946.792246268, -13611020.55832281 4564960.193520165, -13611024.45446502 4565000.962961139, -13611025.67885396 4565012.954013976, -13611027.79402319 4565025.791430018, -13611032.35820089 4565055.274901705, -13611035.58666899 4565076.012283196, -13611036.92249872 4565081.090936223, -13611043.37853051 4565095.197833408, -13611068.75973673 4565130.465940783, -13611084.90084038 4565152.755317466, -13611095.2539544 4565166.016339058, -13611126.42342655 4565205.798590916, -13611136.88722314 4565219.200687214, -13611142.89869742 4565228.229125105, -13611161.0432658 4565255.738731314, -13611161.71137643 4565256.867134775, -13611166.163987 4565265.895946169, -13611144.56838807 4565289.173272189, -13611138.22315258 4565296.226922566, -13611112.39696738 4565325.852437726, -13611078.55602732 4565363.095835653, -13611056.8485074 4565388.912757963, -13611056.29199142 4565389.47712448, -13611030.79977854 4565423.053322723, -13611010.42824953 4565453.24363575, -13610988.27570616 4565486.396456547, -13610986.82850791 4565492.744832956, -13610986.38321115 4565497.82341821, -13610987.05121592 4565504.736583984, -13610988.49853912 4565511.084848448, -13610991.2812882 4565516.869150552, -13610995.0659449 4565521.383656701, -13610998.51729884 4565523.922666249, -13611005.53022549 4565527.873211278, -13611014.21338499 4565530.412728036, -13611022.45065806 4565531.823254283, -13611023.00734379 4565531.823053058, -13611029.57530426 4565531.823186629, -13611037.36738273 4565530.553542401, -13611046.60697115 4565528.155485595, -13611053.8429794 4565525.051627759, -13611066.53326937 4565528.860785631, -13611068.42574044 4565529.566275952, -13611084.90119425 4565535.491321319, -13611090.91243186 4565539.300626368, -13611098.25906317 4565546.354384426, -13611101.37635003 4565550.163273198, -13611102.93472666 4565552.138666151, -13611109.83633609 4565563.001377588, -13611110.17063364 4565580.071633115, -13611109.0575037 4565604.478537405, -13611108.38929112 4565622.677347437, -13611102.26709067 4565698.295887193, -13611100.15165409 4565728.628239751, -13611097.47988321 4565770.105489451, -13611094.91984729 4565803.964999135, -13611092.02535552 4565843.891284771, -13611091.58033612 4565861.667117825, -13611089.7988613 4565884.522768313, -13611088.35187031 4565889.601689698, -13611084.90122663 4565895.950034903, -13611080.11412766 4565901.4524709, -13611069.65019714 4565913.585600931, -13611066.75587298 4565918.664605285, -13611064.08434821 4565921.768405583, -13611060.52204654 4565924.307881967, -13611051.28275048 4565928.963378302, -13611043.60168509 4565930.938904984, -13611035.36395656 4565933.054817816, -13611026.79195527 4565933.901241038, -13611018.55464187 4565933.478283163, -13611013.87902247 4565932.3497603, -13610991.50409156 4565923.602228767, -13610987.8301288 4565922.19146675, -13610981.59671698 4565919.22878906, -13610975.02867536 4565915.701574637, -13610972.46828271 4565914.8551751, -13610967.90404774 4565912.597984934, -13610965.23242596 4565911.328424545, -13610954.43448992 4565904.979587635, -13610948.6458113 4565900.888009779, -13610947.86676575 4565900.464745543, -13610944.41553451 4565898.771912602, -13610940.85342282 4565897.925634629, -13610936.28943521 4565896.51472006, -13610929.16529729 4565895.103680803, -13610924.37855394 4565893.834058108, -13610904.786007 4565888.754899727, -13610875.84300021 4565879.725990362, -13610859.70190496 4565874.929136808, -13610847.56786282 4565870.696547861, -13610842.78132666 4565870.132412956, -13610835.65687081 4565869.568164334, -13610830.64705088 4565869.285502751, -13610821.51913795 4565870.837468598, -13610821.0735839 4565870.978723394, -13610809.16263814 4565878.738274366, -13610789.90411306 4565893.551760337))"
422200,3347,2817,1945,178,6,417,22,0,249,0,249,530,321,0,26,0,0,35,148,43,105,9432.0,"POLYGON ((-13610445.03638795 4559888.85227479, -13610440.8066913 4559863.754217427, -13610428.56149199 4559791.562286394, -13610428.11601052 4559788.460382214, -13610423.99690301 4559763.50354005, -13610419.65578621 4559738.828643994, -13610406.96515658 4559664.945316034, -13610402.8462405 4559640.411936588, -13610398.61654262 4559614.468677227, -13610385.92596615 4559537.061289754, -13610381.69581422 4559511.258950884, -13610377.79960695 4559486.444045045, -13610366.44489754 4559412.421478076, -13610362.66040534 4559387.747786704, -13610358.76406294 4559361.9461607, -13610347.29790297 4559284.963721522, -13610343.51327696 4559259.303327377, -13610337.16778321 4559220.530501458, -13610318.46640512 4559104.212654292, -13610312.23215832 4559065.581936496, -13610335.72098233 4559061.211084384, -13610406.18622763 4559048.240021923, -13610429.78604424 4559044.010510841, -13610450.82536446 4559040.908355362, -13610513.94330849 4559031.885263218, -13610535.09422042 4559028.924490861, -13610559.36185699 4559024.553579909, -13610632.16477922 4559012.006051422, -13610644.07568391 4559010.031738597, -13610655.43012486 4559003.123317347, -13610673.35275416 4558999.880625348, -13610727.45433637 4558990.434620932, -13610745.48799956 4558987.332779742, -13610788.34568705 4558980.847397921, -13610851.13032473 4558971.401097361, -13610868.60707948 4558966.466545335, -13610878.73728673 4558960.403721328, -13610906.90084682 4558936.294781129, -13610909.68399554 4558933.475287091, -13610919.3686281 4558924.593291512, -13610937.29113284 4558913.59627807, -13610947.30997228 4558906.687391517, -13610998.51715611 4558909.648660813, -13611003.0809968 4558905.278065206, -13611006.42048671 4558902.599016343, -13611036.47727756 4558883.56589001, -13611061.85800074 4558878.631350946, -13611138.000157 4558864.250518355, -13611152.24921173 4558861.571776321, -13611158.70566645 4558860.725785534, -13611163.38131237 4558859.175075146, -13611168.83593938 4558911.904080517, -13611169.61486779 4558919.235778724, -13611175.29214747 4559011.019017871, -13611180.63573597 4559070.798556568, -13611185.42263651 4559123.669769899, -13611187.76001881 4559149.188959208, -13611194.88449467 4559226.029119907, -13611197.33357467 4559251.689531362, -13611199.44892632 4559277.209004356, -13611205.7938539 4559353.627109851, -13611208.02032618 4559379.288373286, -13611210.58068555 4559405.51329705, -13611218.48449855 4559484.187914755, -13611221.15599506 4559510.554072286, -13611222.9369566 4559535.369312075, -13611228.39206993 4559609.815688337, -13611230.28415249 4559634.772137251, -13611232.39934532 4559659.305500143, -13611239.07868305 4559732.906828522, -13611241.30500483 4559757.581396333, -13611243.30849629 4559783.524966128, -13611249.31958606 4559861.357205865, -13611251.32368351 4559887.301034936, -13611253.77281376 4559912.258497978, -13611261.11970966 4559987.130091539, -13611263.67997802 4560012.228770256, -13611265.79505283 4560037.750073735, -13611272.47405518 4560114.314679393, -13611274.70082981 4560139.977787763, -13611265.57266207 4560140.82361576, -13611222.82578287 4560148.156068377, -13611067.423538 4560175.087921158, -13611015.66002701 4560184.111888531, -13610962.78354778 4560192.854064464, -13610819.96048426 4560216.5430484, -13610804.26459523 4560218.940340295, -13610751.38769249 4560227.400660761, -13610736.24824951 4560230.079604534, -13610702.74137441 4560235.297023298, -13610700.96005444 4560235.578644681, -13610666.56216374 4560241.92412889, -13610579.39920487 4560256.588590886, -13610556.91281436 4560260.395932878, -13610508.37735705 4560268.714910004, -13610503.47927491 4560243.333891405, -13610489.11892479 4560167.332226593, -13610484.44363755 4560142.092745891, -13610480.32466984 4560116.429952106, -13610468.19118986 4560039.7239258, -13610464.18338276 4560014.202365336, -13610460.28730934 4559989.104367296, -13610448.82130368 4559913.80962244, -13610445.03638795 4559888.85227479))"
422300,3756,3430,2090,202,5,862,0,7,264,0,264,326,147,0,0,0,8,40,131,131,0,10161.0,"POLYGON ((-13613835.27191112 4559667.624338385, -13613852.08070334 4559727.125522449, -13613865.77306009 4559778.731056802, -13613868.55635355 4559793.39541795, -13613872.89790214 4559803.265044228, -13613875.90320735 4559813.699280952, -13613898.94632067 4559913.10467483, -13613908.63097401 4559954.417780221, -13613910.8576441 4559963.441725647, -13613926.66492216 4560024.777765721, -13613938.46487779 4560075.115620613, -13613948.81761591 4560114.033033947, -13613962.28729896 4560163.948152773, -13614007.26005579 4560346.550595419, -13614023.40177437 4560412.119332572, -13614034.19969991 4560452.588280484, -13614066.59363416 4560574.420352589, -13614077.39139847 4560615.031142853, -13614085.74074898 4560649.578994418, -13614090.08223855 4560667.205091991, -13614113.12515187 4560749.979179991, -13614113.79281963 4560752.235306574, -13614123.36672048 4560786.501723931, -13614113.34788443 4560790.026848667, -13614098.87644506 4560793.552056663, -13614024.96020413 4560812.025046081, -13614000.35834047 4560818.370278548, -13613975.53432514 4560824.716062215, -13613919.54027871 4560839.099760602, -13613901.06145504 4560843.611805896, -13613876.23724047 4560849.816670511, -13613852.74889151 4560855.59808703, -13613782.50595898 4560873.225108808, -13613759.12921482 4560879.147294373, -13613749.33303411 4560881.968027419, -13613733.30275843 4560885.91615641, -13613686.43741929 4560897.620440703, -13613656.04705763 4560905.235215014, -13613630.33259567 4560911.862848809, -13613627.99502203 4560912.567994184, -13613621.20434539 4560914.542133446, -13613618.97790647 4560915.388244875, -13613610.29502935 4560918.067476012, -13613596.93654306 4560921.310518734, -13613557.52924649 4560931.322592515, -13613530.47871463 4560937.245501396, -13613508.3263175 4560942.322010394, -13613501.64739138 4560917.50311901, -13613481.83233983 4560843.04788838, -13613475.26459431 4560818.229489812, -13613473.03805717 4560809.063454203, -13613466.35903383 4560781.565968944, -13613464.24356824 4560772.400237805, -13613460.23636297 4560756.043058866, -13613448.21390921 4560707.393735182, -13613444.31731885 4560691.177042267, -13613437.1929038 4560666.641266347, -13613424.0575639 4560620.812532187, -13613416.82171998 4560593.174576549, -13613410.36491041 4560568.63895372, -13613397.67483741 4560518.862694102, -13613377.30343146 4560438.346526287, -13613371.62569096 4560414.516048348, -13613359.82594774 4560369.957845477, -13613346.91331509 4560320.605687933, -13613339.7883604 4560292.968171402, -13613318.74922051 4560210.197561204, -13613311.73610155 4560182.701854656, -13613305.39091133 4560160.564191673, -13613303.83211285 4560154.783079713, -13613288.80445971 4560093.305469702, -13613283.34941691 4560071.026660472, -13613270.88155827 4560021.393841381, -13613244.72174596 4559916.347570309, -13613234.81454248 4559872.21411518, -13613233.59003859 4559866.29216555, -13613221.67878791 4559823.004833055, -13613245.94647246 4559816.096198162, -13613264.53679528 4559811.019884472, -13613319.30565833 4559797.484419181, -13613343.90744171 4559791.562306532, -13613368.50890693 4559785.076273927, -13613442.64754622 4559765.900610198, -13613467.36058348 4559759.55531537, -13613591.25955427 4559726.702831296, -13613631.22288035 4559714.012790226, -13613674.52621402 4559701.604753318, -13613698.79402992 4559698.079994916, -13613713.37677583 4559696.52890937, -13613726.95776772 4559693.849916954, -13613754.0083703 4559687.928321812, -13613835.27191112 4559667.624338385))"
422400,4386,3891,2223,44,0,1396,0,21,207,0,207,495,249,0,0,0,0,201,45,0,45,12588.0,"POLYGON ((-13615441.50061927 4557629.138299505, -13615478.45863402 4557933.07439454, -13615576.64215385 4558824.492431678, -13615933.3099942 4558765.137411139, -13616862.38281669 4558765.137502116, -13617285.95323004 4558898.792316976, -13617850.67710459 4559270.441517375, -13617977.13585811 4559567.65780498, -13618006.74665586 4560043.249390923, -13617865.59368216 4560570.895180657, -13617627.70380397 4561254.675057408, -13617256.11956461 4561693.25396464, -13617449.48164654 4562114.787249205, -13616991.62429507 4562268.370725531, -13615759.76320127 4562681.605715726, -13615744.62371995 4562685.837075995, -13615657.01523842 4562710.377529697, -13615394.52351623 4562784.141402697, -13615324.61508295 4562803.886786881, -13615307.02675423 4562808.682231657, -13615306.47005588 4562806.002688506, -13615304.91171499 4562798.10447083, -13615304.46620057 4562795.565333845, -13615292.44391467 4562790.629004714, -13615275.63471983 4562783.718402709, -13615272.07225436 4562782.166836999, -13615256.59871651 4562775.819882624, -13615244.68765416 4562771.024483555, -13615192.7013216 4562749.586352126, -13615185.68811419 4562757.343998424, -13615161.86605887 4562752.6896628, -13615146.39232881 4562755.933217249, -13615121.12317871 4562761.010815823, -13615071.58576075 4562771.306590924, -13615045.64854015 4562777.512218494, -13615020.6015378 4562783.577423398, -13614971.1754584 4562795.424350358, -13614955.81362725 4562799.232492987, -13614875.10703254 4562806.42550151, -13614861.63754757 4562807.695260595, -13614821.00546681 4562804.874038478, -13614815.32823459 4562804.592401574, -13614770.91167813 4562808.259232265, -13614767.46097294 4562808.541121109, -13614744.30675068 4562808.541435472, -13614743.08220323 4562808.823418646, -13614721.93124664 4562813.90062578, -13614701.89400952 4562827.158795631, -13614678.73914014 4562833.364386072, -13614663.04346704 4562833.78773313, -13614654.80547112 4562834.069689363, -13614635.77033991 4562839.570475362, -13614633.20967122 4562840.275444317, -13614587.56894533 4562849.725306983, -13614585.3425637 4562850.289195416, -13614542.92944997 4562863.547137331, -13614495.06222616 4562877.369111205, -13614448.7534456 4562882.869743505, -13614443.6328503 4562883.716142792, -13614395.32018178 4562892.319631547, -13614379.17869486 4562895.140605991, -13614352.35069166 4562899.935788419, -13614330.75496118 4562902.051448457, -13614314.61333671 4562903.743692135, -13614306.04179936 4562904.590319226, -13614281.32890226 4562908.53920814, -13614258.95364671 4562912.206501003, -13614183.14477667 4562934.067904426, -13614167.89452523 4562938.581092453, -13614151.19623354 4562946.056785126, -13614127.26242127 4562956.775589849, -13614123.14386342 4562958.750609791, -13614056.79725534 4562977.367709744, -13614052.90108561 4562977.791293224, -13614027.63153668 4562981.035211119, -13614018.16971837 4562945.351171457, -13614010.15475541 4562914.463298501, -13613992.12082663 4562837.454790642, -13613983.77160323 4562801.489038449, -13613970.30191683 4562750.432798433, -13613930.11586936 4562597.406155018, -13613918.87236428 4562554.671705362, -13613916.86893419 4562546.491526922, -13613904.73513807 4562497.552156013, -13613868.44508705 4562351.016455683, -13613856.4223189 4562302.218923038, -13613880.46728342 4562295.872365994, -13613952.82496246 4562277.255635869, -13613976.98153368 4562271.050427126, -13614002.6963741 4562264.562950457, -13614080.06310001 4562245.523405812, -13614095.98207233 4562241.71582593, -13614105.88945794 4562239.035958929, -13614129.37753533 4562232.548513935, -13614200.06578664 4562213.649849964, -13614223.6655598 4562207.444473356, -13614248.60112054 4562201.380113247, -13614323.85266311 4562183.469181153, -13614348.89983552 4562177.546145472, -13614372.83354414 4562170.917398524, -13614444.6347413 4562151.455272056, -13614458.99500109 4562147.647446834, -13614468.67957724 4562145.108578023, -13614460.21923892 4562111.82510541, -13614434.8386209 4562012.117136017, -13614426.4896516 4561978.975033017, -13614417.36112945 4561946.115440095, -13614390.08820057 4561847.677642196, -13614381.071059 4561814.959402205, -13614373.38982002 4561782.523580481, -13614350.45828608 4561685.638499223, -13614344.33562333 4561659.83135205, -13614342.777404 4561653.48503847, -13614329.97545389 4561604.267305377, -13614291.57030372 4561456.616545523, -13614278.87988923 4561407.39994173, -13614266.41178322 4561357.337594003, -13614229.23119877 4561207.71580479, -13614216.87470511 4561157.795318295, -13614207.30146194 4561122.822576157, -13614201.6241955 4561101.669962849, -13614190.82618887 4561060.352217483, -13614180.47346965 4561017.765428871, -13614171.90163938 4560982.652550835, -13614161.43780965 4560943.5911769, -13614153.75643796 4560914.541993423, -13614145.07377269 4560876.608996486, -13614131.71534231 4560826.126503902, -13614128.93251192 4560815.268075512, -13614126.2609742 4560802.858868831, -13614123.36672048 4560786.501723931, -13614113.79281963 4560752.235306574, -13614113.12515187 4560749.979179991, -13614090.08223855 4560667.205091991, -13614085.74074898 4560649.578994418, -13614077.39139847 4560615.031142853, -13614066.59363416 4560574.420352589, -13614034.19969991 4560452.588280484, -13614023.40177437 4560412.119332572, -13614007.26005579 4560346.550595419, -13613962.28729896 4560163.948152773, -13613948.81761591 4560114.033033947, -13613938.46487779 4560075.115620613, -13613926.66492216 4560024.777765721, -13613910.8576441 4559963.441725647, -13613908.63097401 4559954.417780221, -13613898.94632067 4559913.10467483, -13613875.90320735 4559813.699280952, -13613872.89790214 4559803.265044228, -13613868.55635355 4559793.39541795, -13613865.77306009 4559778.731056802, -13613852.08070334 4559727.125522449, -13613835.27191112 4559667.624338385, -13613754.0083703 4559687.928321812, -13613726.95776772 4559693.849916954, -13613713.37677583 4559696.52890937, -13613698.79402992 4559698.079994916, -13613674.52621402 4559701.604753318, -13613631.22288035 4559714.012790226, -13613591.25955427 4559726.702831296, -13613467.36058348 4559759.55531537, -13613442.64754622 4559765.900610198, -13613368.50890693 4559785.076273927, -13613343.90744171 4559791.562306532, -13613319.30565833 4559797.484419181, -13613264.53679528 4559811.019884472, -13613245.94647246 4559816.096198162, -13613221.67878791 4559823.004833055, -13613215.55603448 4559798.47115453, -13613197.29977514 4559725.292761971, -13613191.288251 4559700.900254323, -13613184.38632725 4559675.802176955, -13613176.59424444 4559647.038583061, -13613164.34929129 4559600.50996, -13613157.78120016 4559575.412370319, -13613151.43585708 4559551.583772036, -13613132.40020013 4559480.522023464, -13613126.16672084 4559456.975831304, -13613122.82695255 4559444.427334531, -13613122.27012424 4559442.312377082, -13613112.47406316 4559406.922909094, -13613109.13439378 4559394.515714735, -13613106.01746019 4559382.249197065, -13613097.00103997 4559345.590669821, -13613093.99524676 4559333.465157987, -13613091.10100367 4559321.198695961, -13613082.41781154 4559284.540632233, -13613079.52366168 4559272.415469433, -13613076.8521356 4559262.545644735, -13613069.05966234 4559232.9373507, -13613066.49919121 4559223.068410649, -13613061.8238987 4559205.162130469, -13613047.7975372 4559151.444600535, -13613043.2333462 4559133.538713095, -13613034.88459217 4559096.599626004, -13613034.10547217 4559092.792699891, -13613029.65269911 4559069.670387194, -13613025.64508916 4559053.315690403, -13613010.06026349 4558985.922614112, -13613001.59969459 4558949.266215206, -13612997.36983618 4558934.744397194, -13612985.01357847 4558891.461227532, -13612981.00591187 4558877.080137548, -13612975.7737973 4558853.958594042, -13612960.07773245 4558784.875015913, -13612954.95738169 4558761.894615762, -13612952.28562528 4558751.038861357, -13612944.27032359 4558718.330423968, -13612941.59865822 4558707.615377732, -13612939.2612761 4558698.169462127, -13612935.03084 4558678.431355014, -13612934.58562718 4558676.175589279, -13612932.02552194 4558662.9231863, -13612929.91035722 4558656.156212308, -13612927.0156667 4558651.785423871, -13612923.89921224 4558644.454409779, -13612910.87479134 4558593.27747745, -13612903.63883828 4558564.516907622, -13612899.1860445 4558552.392577731, -13612899.07487875 4558552.110398747, -13612889.05570927 4558513.622285776, -13612885.82798748 4558500.792659718, -13612883.82415586 4558493.321036276, -13612877.92385523 4558471.186657398, -13612876.03170852 4558463.855428825, -13612872.24660886 4558449.89857565, -13612870.24273226 4558442.285752038, -13612866.34673725 4558421.279565996, -13612863.11854153 4558407.322465518, -13612859.89029031 4558393.224149393, -13612856.43936709 4558380.254002853, -13612846.08671582 4558341.484313692, -13612842.74692432 4558328.655167904, -13612902.0806091 4558313.57039292, -13613080.19181325 4558268.59802846, -13613139.635918 4558253.654621907, -13613146.87168612 4558253.513833406, -13613168.57906648 4558253.231525493, -13613175.9265055 4558253.231657729, -13613211.65997444 4558244.34989911, -13613245.16727396 4558235.891296201, -13613285.13069991 4558226.022684397, -13613359.04700181 4558207.695517931, -13613453.22323325 4558184.293256316, -13613522.68636567 4558167.094070589, -13613583.57828009 4558154.124477529, -13613658.49656487 4558138.475978283, -13613766.3651239 4558115.919484957, -13613827.36771321 4558103.372472299, -13613833.26792609 4558102.808829161, -13613851.19021955 4558101.398586768, -13613857.20161732 4558101.117086994, -13613880.69006666 4558097.4515736, -13613926.44249215 4558090.684611348, -13613951.04412684 4558085.186822372, -13613974.42074936 4558080.252627814, -13614028.18805877 4558063.335106823, -13614189.71270506 4558012.583849956, -13614210.0841677 4558006.239931789, -13614223.77687431 4558000.037147996, -13614242.58968716 4557991.437786682, -13614267.30234937 4557979.03199986, -13614341.55263287 4557941.673990235, -13614366.376746 4557929.408946786, -13614380.06946971 4557924.474752761, -13614421.36856272 4557909.813820406, -13614435.17235102 4557905.020480772, -13614440.73807163 4557903.328748812, -13614457.43644712 4557898.394771909, -13614463.11384585 4557896.843951428, -13614468.12279782 4557895.293248043, -13614483.15095984 4557890.923014989, -13614488.27167754 4557889.654451587, -13615136.3740576 4557712.593180867, -13615441.50061927 4557629.138299505))"
422500,4047,3626,1991,135,7,1228,11,0,254,21,233,421,203,0,6,5,0,139,68,25,43,13974.0,"POLYGON ((-13612466.59849521 4562813.759678544, -13612496.7659438 4562778.640905567, -13612490.75477501 4562773.845526902, -13612487.63800367 4562766.511501294, -13612488.52866817 4562752.548261055, -13612487.86067796 4562738.303587189, -13612486.41322675 4562730.263998992, -13612479.40051519 4562713.057632408, -13612472.27597281 4562699.376397412, -13612463.37046489 4562687.670363348, -13612449.12117543 4562669.053062212, -13612445.4476858 4562663.834722583, -13612458.69460736 4562654.667326264, -13612498.54706218 4562627.588097134, -13612503.44507181 4562624.344190072, -13612511.68275283 4562618.279660504, -13612509.79022812 4562588.520523929, -13612504.22435204 4562499.244479343, -13612502.44350969 4562469.48596797, -13612499.77182555 4562441.137543062, -13612491.7564597 4562356.516578531, -13612489.08488792 4562328.309742086, -13612489.41921222 4562324.220188664, -13612486.85855402 4562320.976033603, -13612480.95852816 4562294.320824848, -13612479.84540791 4562282.050753736, -13612473.61168367 4562209.983035117, -13612472.49845474 4562189.392762662, -13612467.82293043 4562136.646549868, -13612463.70409261 4562088.273208109, -13612462.59125121 4562073.888149245, -13612459.25166705 4562030.873791485, -13612458.24939896 4562016.629801525, -13612488.97394029 4562013.668324756, -13612508.56607497 4562010.283423718, -13612538.06560805 4562005.206290906, -13612659.06996659 4561985.321620884, -13612689.34862698 4561980.385627104, -13612709.16360075 4561976.295666693, -13612722.07683905 4561973.615723711, -13612734.76710209 4561971.641598261, -13612747.45748848 4561969.949448111, -13612768.0515826 4561969.526085997, -13612812.24573843 4561965.436291561, -13612816.14163673 4561965.15449319, -13612838.07176222 4561961.769786408, -13612849.64893924 4561959.654271235, -13612884.82606131 4561953.730908872, -13612896.51435749 4561951.756332368, -13612914.54803124 4561948.795143949, -13612968.76091251 4561940.473942218, -13612986.90575084 4561937.794899848, -13613015.51485009 4561933.281596258, -13613031.76761373 4561930.884263927, -13613100.67426454 4561913.537515984, -13613116.92679235 4561909.588832135, -13613128.83837816 4561905.499370599, -13613150.10014931 4561902.114625133, -13613213.8861615 4561892.383405272, -13613235.25958659 4561889.140050017, -13613254.40647191 4561885.896226462, -13613311.95883551 4561876.447388849, -13613331.21681312 4561873.34498255, -13613350.36421134 4561870.100989855, -13613408.25003467 4561860.370471924, -13613427.5085257 4561857.267894703, -13613446.54422497 4561854.02402097, -13613503.65097299 4561844.857309153, -13613522.79776764 4561841.754851995, -13613541.49948051 4561838.229138467, -13613597.60477007 4561828.075067662, -13613610.8515292 4561825.677429928, -13613615.19278574 4561821.164931246, -13613637.45682034 4561816.934012, -13613638.01323132 4561816.792960183, -13613696.90170699 4561809.459367032, -13613706.69786073 4561807.062275131, -13613713.93353702 4561805.369848895, -13613729.40688957 4561801.139200844, -13613761.1326532 4561808.049372406, -13613771.81976282 4561970.513577386, -13613814.56640746 4562135.377707221, -13613822.91533901 4562168.660927163, -13613847.96202959 4562268.793749036, -13613849.40921613 4562274.576241522, -13613856.4223189 4562302.218923038, -13613868.44508705 4562351.016455683, -13613904.73513807 4562497.552156013, -13613916.86893419 4562546.491526922, -13613918.87236428 4562554.671705362, -13613930.11586936 4562597.406155018, -13613970.30191683 4562750.432798433, -13613983.77160323 4562801.489038449, -13613992.12082663 4562837.454790642, -13614010.15475541 4562914.463298501, -13614018.16971837 4562945.351171457, -13614027.63153668 4562981.035211119, -13614012.60348956 4562982.868708052, -13614007.37164944 4562983.573906546, -13613998.46625331 4562977.509202718, -13613968.07583124 4562957.19871956, -13613954.16106339 4562936.183537435, -13613938.68765616 4562919.963985083, -13613923.77049811 4562917.284223489, -13613893.71420187 4562912.206686336, -13613866.99744275 4562907.551954981, -13613784.51002726 4562879.0616145, -13613772.82151103 4562874.971486161, -13613747.32922375 4562875.817880067, -13613704.91651509 4562898.243319264, -13613689.3319923 4562902.19264826, -13613680.20348994 4562904.449173257, -13613608.51368567 4562909.103267156, -13613588.8100217 4562914.181203699, -13613569.44065152 4562919.117495825, -13613536.71260555 4562927.579910331, -13613510.99808694 4562928.56704273, -13613491.40549089 4562929.413700712, -13613472.70432006 4562930.118957076, -13613461.12709242 4562930.682844664, -13613417.48959817 4562940.273883345, -13613405.46691166 4562943.094441926, -13613399.12188555 4562943.658697682, -13613378.5276742 4562945.351558239, -13613353.0355065 4562954.660324355, -13613303.16430569 4562939.709688335, -13613295.70590232 4562937.453229268, -13613292.03228702 4562916.014315367, -13613291.69876087 4562914.321965913, -13613288.58139166 4562935.337177438, -13613283.57226569 4562933.785867441, -13613273.10847604 4562932.798670832, -13613272.21747749 4562932.657433955, -13613256.5213327 4562931.388269112, -13613233.47854523 4562936.042452721, -13613210.99215685 4562946.197574153, -13613205.98272491 4562947.466952797, -13613187.94893933 4562952.403605131, -13613183.60744959 4562950.852202347, -13613142.41915777 4562936.042719288, -13613094.88561968 4562917.565789463, -13613030.54287845 4562892.601670334, -13613004.71708294 4562879.908141616, -13612993.58475198 4562874.407323953, -13612960.18896513 4562857.90539797, -13612949.0573156 4562852.545841999, -13612944.04781852 4562850.007045118, -13612939.92913935 4562848.45554885, -13612924.12161521 4562842.532106518, -13612897.85035151 4562832.94109797, -13612846.64323145 4562832.376839815, -13612820.59449698 4562832.094913186, -13612798.88700712 4562831.813111162, -13612745.78761186 4562831.389974569, -13612734.09906306 4562832.517928616, -13612712.61480821 4562834.633912789, -13612698.69958105 4562835.90314727, -13612604.52308805 4562839.006007638, -13612565.56181126 4562839.006059257, -13612555.98782803 4562839.006044533, -13612482.62859682 4562842.813988034, -13612457.91539625 4562840.557638427, -13612466.59849521 4562813.759678544))"
422600,1264,1096,498,50,0,509,0,0,39,12,27,168,99,0,0,0,0,67,2,2,0,1215.0,"POLYGON ((-13612423.51792509 4563376.667328136, -13612409.71429924 4563408.262224578, -13612401.25370443 4563427.867916592, -13612384.22179896 4563483.30011461, -13612339.24908641 4563630.1337766, -13612333.46017743 4563650.163224211, -13612332.79252279 4563652.984128705, -13612330.23199481 4563670.192484838, -13612329.78675323 4563684.72101119, -13612331.90181275 4563709.264185331, -13612336.4660069 4563728.306327756, -13612350.38087199 4563785.432380384, -13612355.05621995 4563804.474940076, -13612357.50542279 4563814.34864178, -13612368.97111179 4563855.677395, -13612377.76540293 4563886.991789019, -13612392.1255726 4563943.977923431, -13612404.8161223 4563986.012853514, -13612410.60497737 4564009.428315978, -13612411.38386347 4564012.390362704, -13612414.38966507 4564035.664813612, -13612415.28030944 4564057.951549895, -13612415.50302145 4564063.312136557, -13612439.32506734 4564062.465773341, -13612453.57389138 4564062.042600408, -13612483.96447385 4564059.362348594, -13612511.01525835 4564057.669430479, -13612512.01680485 4564057.669720491, -13612534.94846105 4564055.69495085, -13612556.87868076 4564054.002463494, -13612622.66841352 4564049.488235146, -13612644.70976374 4564047.936583068, -13612672.09434052 4564046.244099821, -13612754.47097236 4564041.588996137, -13612781.9666712 4564040.037813971, -13612803.00624163 4564038.062778455, -13612866.23561875 4564032.561620448, -13612887.38631452 4564030.728004412, -13612898.96352508 4564029.881517358, -13612934.02905706 4564027.483561323, -13612945.71742024 4564026.778039414, -13612945.71738722 4564080.239101078, -13612945.71740871 4564240.904824195, -13612945.7174303 4564294.507714915, -13612944.71580504 4564347.969889356, -13612942.15544026 4564508.780821853, -13612941.2649272 4564562.38510938, -13612939.92870913 4564614.438063204, -13612936.36677438 4564770.879957884, -13612935.25333298 4564823.074683517, -13612933.36139336 4564867.511129895, -13612928.12893318 4565001.244956198, -13612926.34809109 4565045.823184677, -13612924.90096674 4565061.905073392, -13612921.56098143 4565099.853443557, -13612920.55956069 4565110.15145769, -13612919.22358342 4565126.375048261, -13612899.85406201 4565134.416208444, -13612846.42077576 4565157.128440987, -13612841.85636116 4565158.398463408, -13612822.15295149 4565164.182050236, -13612816.58706866 4565165.875201406, -13612815.91891638 4565165.028416567, -13612811.8004582 4565158.3980275, -13612808.57204677 4565151.90894133, -13612807.56994055 4565149.651503879, -13612804.67592434 4565143.021380702, -13612803.89628208 4565141.328660132, -13612800.33423847 4565131.594591427, -13612790.98376416 4565108.881815272, -13612787.53245741 4565097.032214527, -13612782.30062782 4565078.834018867, -13612775.62153204 4565081.93752073, -13612750.79736589 4565094.492498638, -13612727.75404238 4565105.3549628, -13612654.17171316 4565140.764037383, -13612563.11249192 4565180.546574405, -13612530.16202952 4565195.077080672, -13612522.59201966 4565196.346664409, -13612512.4622933 4565196.911039895, -13612506.78503089 4565196.769961075, -13612498.10181152 4565215.81490635, -13612491.20003825 4565233.025538214, -13612487.30417251 4565243.042105841, -13612481.07027267 4565255.174238012, -13612476.61725275 4565261.381617206, -13612468.15706012 4565267.729709174, -13612456.57988508 4565273.372850287, -13612427.19156017 4565283.24804449, -13612409.15780046 4565287.903478823, -13612377.32041968 4565296.226783102, -13612359.39754926 4565292.135691478, -13612358.39622142 4565291.571230498, -13612304.62836472 4565265.472521205, -13612286.70603429 4565256.86693212, -13612302.29071408 4565239.091913581, -13612306.18710063 4565231.332612174, -13612307.41170963 4565228.934419529, -13612308.41325154 4565225.830739823, -13612307.07740698 4565219.482546632, -13612291.04787494 4565200.861059224, -13612289.60076651 4565198.322047147, -13612286.81726486 4565189.434281494, -13612286.48360933 4565184.355479588, -13612287.0401598 4565179.841426405, -13612288.48731982 4565175.46815272, -13612304.62874117 4565141.328655642, -13612319.32263286 4565110.857020257, -13612322.21728579 4565097.455454894, -13612323.99812734 4565075.871469585, -13612325.33400195 4565061.341044319, -13612324.88901642 4565045.964380399, -13612317.87567879 4564986.855976363, -13612316.76237633 4564970.068478721, -13612316.09464192 4564958.92413003, -13612316.09445874 4564934.659870648, -13612318.43200556 4564918.860356849, -13612318.76621651 4564916.885601228, -13612330.23185732 4564873.294941859, -13612333.01488265 4564862.997266721, -13612333.57173657 4564857.918645073, -13612333.12654553 4564849.031526682, -13612329.89822227 4564837.6048907, -13612329.45295915 4564836.899427813, -13612309.19250288 4564803.043557917, -13612301.73406241 4564792.180981292, -13612296.7251015 4564785.833237959, -13612284.59121389 4564770.456929512, -13612247.5216659 4564729.124256151, -13612233.3840109 4564713.46584304, -13612224.03346264 4564705.142665798, -13612211.45418432 4564696.820226226, -13612190.74862457 4564688.355870883, -13612174.27377934 4564685.111807032, -13612121.50786221 4564677.071102507, -13612109.7083487 4564675.236883793, -13612060.72776201 4564668.324872291, -13612058.056024 4564667.760613102, -13612050.48640636 4564666.208601784, -13612047.92582326 4564665.78537543, -13612041.24676712 4564664.374720567, -13612023.4356616 4564661.835791175, -13611987.1452264 4564656.898546244, -13611961.87580225 4564651.678926245, -13611950.52130279 4564648.293504033, -13611950.18743675 4564648.293198295, -13611939.61193166 4564643.779280095, -13611928.59155777 4564634.892524585, -13611926.9215209 4564625.299775224, -13611921.46722842 4564618.669863291, -13611919.01796572 4564615.707211885, -13611890.51993196 4564576.209523816, -13611880.27882607 4564561.961702557, -13611869.81472758 4564543.905796277, -13611854.78650455 4564517.94996749, -13611837.75466401 4564490.583753213, -13611835.63973402 4564487.198059884, -13611827.51347911 4564472.527373451, -13611822.05837609 4564461.665510694, -13611818.38499101 4564443.327309336, -13611817.38314621 4564436.274413311, -13611817.04940619 4564427.105299273, -13611818.94166991 4564414.973918154, -13611823.50585891 4564401.009107183, -13611845.76978531 4564357.279747367, -13611850.66756126 4564344.302207431, -13611853.89593376 4564331.042228204, -13611857.56943204 4564310.447218009, -13611858.45994028 4564301.137272291, -13611859.12789165 4564276.733844994, -13611858.4601793 4564261.076245035, -13611856.79060031 4564243.020597585, -13611852.78308043 4564219.181648995, -13611830.51882293 4564104.924206147, -13611828.40386829 4564093.356998825, -13611825.39837292 4564078.405186669, -13611795.11944773 4563905.046774413, -13611789.55359532 4563870.34731641, -13611772.85516507 4563766.390338561, -13611768.95936568 4563741.706054825, -13611767.28950323 4563731.832632751, -13611764.17239157 4563711.661920618, -13611754.82169125 4563651.150588123, -13611751.70462586 4563630.980027606, -13611749.36703574 4563616.028905203, -13611747.14083535 4563598.679387176, -13611745.69363251 4563586.83131233, -13611742.35375664 4563566.378821091, -13611736.00843648 4563536.758384015, -13611729.10672531 4563507.561028698, -13611727.88218593 4563503.470340185, -13611719.08807391 4563472.721752126, -13611711.29587425 4563447.896797564, -13611711.18469031 4563447.614474224, -13611704.17143349 4563428.150179532, -13611688.92044495 4563393.170251347, -13611680.6828868 4563376.526495626, -13611669.43937666 4563353.817778157, -13611666.99060835 4563349.586024156, -13611659.9776632 4563337.173678014, -13611657.64003263 4563333.083522017, -13611649.84713366 4563320.389374246, -13611644.61509655 4563313.196109425, -13611630.81186691 4563294.436468201, -13611601.64628347 4563258.328915936, -13611601.42344798 4563258.046869493, -13611590.73649829 4563246.198568509, -13611586.61776092 4563240.980168488, -13611602.3137544 4563224.3362758, -13611623.68734267 4563202.192327649, -13611649.73595818 4563174.829391963, -13611665.6545306 4563158.327394946, -13611688.36381236 4563141.401809184, -13611739.90503608 4563103.319908551, -13611757.15914728 4563091.472165871, -13611780.53674274 4563075.675187937, -13611820.16645863 4563050.287310542, -13611839.09066593 4563038.580622904, -13612016.19978256 4562930.541825174, -13612075.31073797 4562894.576518576, -13612096.0158456 4562881.882280227, -13612158.46591424 4562844.08344136, -13612179.28309294 4562831.530684823, -13612199.43197406 4562818.83715399, -13612260.21224588 4562781.038721154, -13612280.47206925 4562768.486098262, -13612297.72706578 4562757.485007684, -13612349.93575823 4562724.904929183, -13612367.30123927 4562714.185486764, -13612382.88629366 4562704.171879887, -13612401.58765286 4562692.465680147, -13612429.75173207 4562673.989391861, -13612445.4476858 4562663.834722583, -13612449.12117543 4562669.053062212, -13612463.37046489 4562687.670363348, -13612472.27597281 4562699.376397412, -13612479.40051519 4562713.057632408, -13612486.41322675 4562730.263998992, -13612487.86067796 4562738.303587189, -13612488.52866817 4562752.548261055, -13612487.63800367 4562766.511501294, -13612490.75477501 4562773.845526902, -13612496.7659438 4562778.640905567, -13612466.59849521 4562813.759678544, -13612457.91539625 4562840.557638427, -13612455.02133574 4562843.942334975, -13612433.3139518 4562871.022494973, -13612370.97529361 4563076.662365904, -13612359.0637695 4563104.165895098, -13612402.03309957 4563103.037474307, -13612369.3055358 4563189.216339576, -13612365.52017624 4563198.948033154, -13612373.09031201 4563200.076848383, -13612380.88233026 4563200.499742114, -13612389.00856413 4563200.499604181, -13612401.25412474 4563199.371157449, -13612417.84081926 4563196.268317292, -13612434.42703222 4563192.036786363, -13612470.49450144 4563178.355419478, -13612499.4377353 4563166.084576799, -13612510.4583734 4563160.724811121, -13612508.00956167 4563177.086059821, -13612500.88479858 4563226.451972292, -13612498.6587522 4563242.9546213, -13612487.74913688 4563260.444591911, -13612455.02121366 4563312.91404316, -13612444.11202508 4563330.403514576, -13612435.42932637 4563349.868364122, -13612423.51792509 4563376.667328136))"
422700,5053,4128,2214,150,27,1431,11,0,295,48,247,925,525,4,0,22,0,327,47,30,17,14655.0,"POLYGON ((-13612023.76943128 4558580.589141525, -13612025.99614691 4558591.72683288, -13612030.78287342 4558617.385342224, -13612032.34115946 4558625.703462879, -13612044.80914708 4558694.927021842, -13612049.48446623 4558720.867956804, -13612043.47293995 4558721.854605603, -13612038.35249383 4558722.700633954, -13612031.56172803 4558722.982481104, -13612025.32812168 4558723.969684501, -13612019.42825202 4558725.097279141, -13611977.46086026 4558732.146889688, -13611851.66944665 4558753.435681529, -13611809.81349412 4558760.625590175, -13611749.70118837 4558769.085074888, -13611709.95994859 4558774.724279586, -13611569.92010022 4558797.987038488, -13611510.14164593 4558808.13804782, -13611486.87561698 4558811.521678587, -13611473.18342298 4558813.636262188, -13611417.52371353 4558822.941749395, -13611394.48045336 4558826.889012591, -13611370.76919517 4558830.695482269, -13611299.97026782 4558842.53862239, -13611291.8438925 4558843.948592814, -13611276.259193 4558843.525254175, -13611253.54981695 4558844.794147625, -13611253.32721441 4558844.935358685, -13611185.86792143 4558855.509289541, -13611163.38131237 4558859.175075146, -13611157.59268964 4558808.983713515, -13611155.5889886 4558790.514416988, -13611149.57732406 4558727.494202546, -13611144.56821597 4558657.988786846, -13611141.11717066 4558607.657743359, -13611139.55896076 4558582.139677786, -13611134.99483437 4558505.586145869, -13611133.54772796 4558480.209288491, -13611131.20995222 4558454.409812338, -13611130.43079616 4558444.259484493, -13611125.08755281 4558406.47632882, -13611123.41729032 4558392.519499319, -13611123.52887089 4558377.293562847, -13611123.63989365 4558369.680464245, -13611124.75328939 4558351.494256075, -13611129.42864949 4558328.937241829, -13611164.38283961 4558215.308753051, -13611181.19261017 4558158.494553455, -13611204.56971825 4558084.058495319, -13611207.12993904 4558075.740928193, -13611210.9149003 4558061.925631543, -13611217.59384761 4558036.550042071, -13611223.15989064 4558002.856814273, -13611225.72003004 4557979.736750662, -13611226.38821249 4557973.393055534, -13611229.39350438 4557957.321870582, -13611231.84294591 4557944.493424646, -13611235.51630275 4557918.131140979, -13611238.52176728 4557891.768837678, -13611238.52180526 4557890.077557569, -13611239.07832455 4557876.261797724, -13611240.3027686 4557869.917945817, -13611240.85947538 4557867.66269527, -13611233.95767106 4557847.926276832, -13611232.28770718 4557844.260780572, -13611230.50662696 4557840.313679918, -13611219.04119623 4557823.678814962, -13611187.64868215 4557792.805967021, -13611187.09223918 4557792.241854385, -13611180.30169753 4557783.924435515, -13611175.51503708 4557772.787944444, -13611187.64892062 4557773.210645596, -13611224.27323746 4557774.620488595, -13611236.51819192 4557775.18465507, -13611259.33875562 4557770.955077751, -13611298.18892684 4557764.047564987, -13611309.54367294 4557761.932853798, -13611328.1340626 4557758.549967855, -13611351.06562277 4557754.461715146, -13611386.0201305 4557747.694945984, -13611435.55712541 4557735.712070941, -13611584.28015855 4557699.764690505, -13611633.92891473 4557687.923012876, -13611661.09085827 4557687.923084848, -13611728.10524075 4557687.922883162, -13611737.12175085 4557702.443005169, -13611754.04221506 4557729.65072701, -13611758.16102115 4557754.884675311, -13611770.85177593 4557830.586616083, -13611775.08173815 4557855.961746738, -13611781.20430724 4557900.086681865, -13611785.76842129 4557932.93356849, -13611865.58449657 4557923.769994181, -13611883.17291478 4557921.937481846, -13611891.18803599 4557920.527445833, -13611900.9842067 4557919.258741086, -13611908.33139265 4557957.039885875, -13611910.00108892 4557965.357223751, -13611913.45168908 4557983.965960463, -13611928.48026199 4558064.886090097, -13611933.48968379 4558091.953370771, -13611935.60479985 4558102.103954245, -13611938.16491766 4558116.060320049, -13611951.74610406 4558188.522697377, -13611956.30987416 4558212.77079694, -13611958.75888185 4558224.895020541, -13611960.20591881 4558232.930660227, -13611971.56058125 4558293.692635434, -13611975.34570572 4558313.993590966, -13611976.34736693 4558320.19668918, -13611979.68727316 4558339.087637376, -13611980.91162538 4558345.431994694, -13611983.47164239 4558358.824886382, -13611991.37566214 4558399.427380805, -13611994.04736186 4558412.961294628, -13611995.71702684 4558423.817172757, -13612001.06029228 4558456.383463494, -13612002.84162852 4558467.380341785, -13612007.40584951 4558492.192858571, -13612021.20914966 4558566.772841672, -13612023.76943128 4558580.589141525))"
422800,9155,7600,2687,361,41,3953,73,7,478,79,399,1555,767,7,26,24,0,656,75,22,53,25104.0,"POLYGON ((-13609919.05223383 4559847.116109316, -13609948.88564319 4559841.758381884, -13609970.48127978 4559838.091821436, -13610124.99293921 4559811.584256933, -13610176.53387944 4559802.842364979, -13610225.95985446 4559794.805146759, -13610374.46011604 4559771.258302527, -13610423.99690301 4559763.50354005, -13610428.11601052 4559788.460382214, -13610428.56149199 4559791.562286394, -13610440.8066913 4559863.754217427, -13610445.03638795 4559888.85227479, -13610448.82130368 4559913.80962244, -13610460.28730934 4559989.104367296, -13610464.18338276 4560014.202365336, -13610468.19118986 4560039.7239258, -13610480.32466984 4560116.429952106, -13610484.44363755 4560142.092745891, -13610489.11892479 4560167.332226593, -13610503.47927491 4560243.333891405, -13610508.37735705 4560268.714910004, -13610457.50448329 4560276.611421202, -13610305.10808552 4560300.300676006, -13610254.34599577 4560308.337774562, -13610204.02971981 4560316.234048923, -13610197.23918671 4560317.362281433, -13610165.84748267 4560322.579343175, -13610053.52612229 4560341.615505164, -13610003.4323518 4560350.216602391, -13609954.34015338 4560358.254107583, -13609807.2869781 4560382.648415769, -13609767.87986779 4560389.275898432, -13609758.75190989 4560393.364807355, -13609742.94446639 4560395.761924407, -13609709.21449399 4560401.120256858, -13609695.74524905 4560402.389304852, -13609680.04928814 4560404.081491875, -13609651.10582488 4560408.453009109, -13609615.70657702 4560414.093382427, -13609564.6109273 4560422.835958463, -13609535.77907713 4560427.770804503, -13609528.32034341 4560428.758295538, -13609505.94528675 4560431.719030338, -13609498.59819174 4560432.847509664, -13609478.0040541 4560436.372606525, -13609416.44421766 4560446.807036745, -13609395.96166513 4560450.473556717, -13609366.35058441 4560455.549822439, -13609277.40615364 4560471.060325433, -13609247.90659773 4560476.277844855, -13609243.78817925 4560425.655930063, -13609231.43144039 4560273.791054717, -13609227.31259939 4560223.170105083, -13609226.64466268 4560214.146025618, -13609224.97515946 4560187.073086034, -13609224.41828046 4560178.048785233, -13609220.74472696 4560136.170287417, -13609209.94690875 4560010.677687, -13609206.3845292 4559968.940853462, -13609205.71662397 4559959.916991128, -13609203.71297074 4559933.267494747, -13609203.15613496 4559924.384664075, -13609231.6539476 4559922.410603384, -13609317.1473787 4559916.911139201, -13609345.7567855 4559915.078341361, -13609374.69977218 4559912.258223634, -13609461.8629802 4559904.221535307, -13609490.91697856 4559901.54209274, -13609640.75307138 4559889.698461693, -13609696.07925429 4559910.707107365, -13609811.40619808 4559864.740905643, -13609919.05223383 4559847.116109316))"
422900,5463,5111,2080,610,0,1972,140,0,309,106,203,352,191,0,0,0,0,125,36,26,10,8672.0,"POLYGON ((-13612760.92733705 4559898.299426902, -13612743.45033048 4559901.683251821, -13612741.66911818 4559901.965217031, -13612683.89412044 4559912.399651861, -13612664.63585024 4559916.065302853, -13612646.04569744 4559918.744429917, -13612595.06144722 4559926.217438751, -13612590.2746148 4559926.781609684, -13612571.79553676 4559929.601571064, -13612559.32749095 4559931.434441125, -13612522.03551011 4559936.933827602, -13612509.67912753 4559938.90760961, -13612506.2282952 4559939.471749688, -13612496.0980212 4559941.445524623, -13612492.75835639 4559942.291880963, -13612471.16273855 4559945.816773672, -13612406.37471507 4559956.533004547, -13612384.89014987 4559960.198689053, -13612364.62978211 4559963.442018905, -13612350.15850492 4559965.979734224, -13612303.96075472 4559974.439924784, -13612283.81161593 4559978.24726071, -13612282.36464359 4559964.569899024, -13612279.91561769 4559952.866932456, -13612279.91556188 4559952.725678364, -13612268.56094009 4559914.514319553, -13612255.64826168 4559881.802177642, -13612246.5198224 4559858.818914235, -13612238.61592077 4559840.348078703, -13612237.28031266 4559835.695297382, -13612229.26544815 4559807.4949926, -13612225.14652202 4559788.037312763, -13612220.47118022 4559761.388137839, -13612219.35785328 4559754.338701453, -13612217.57705631 4559735.867378102, -13612213.45772439 4559711.052027843, -13612201.21260723 4559636.604905217, -13612197.20553745 4559611.789508173, -13612193.19791657 4559586.974163932, -13612181.28689385 4559512.810119378, -13612177.3904472 4559488.135967217, -13612173.04893167 4559462.616089782, -13612160.24717308 4559386.055684511, -13612156.0173537 4559360.535769171, -13612151.78703899 4559335.157155617, -13612139.09684155 4559259.16235075, -13612134.86666439 4559233.924648415, -13612130.97019899 4559208.687302659, -13612127.85323221 4559187.538387619, -13612118.16834188 4559133.25692083, -13612113.71572387 4559108.301417287, -13612109.04014081 4559076.719596525, -13612095.23676703 4558981.9752785, -13612090.67238617 4558950.534787432, -13612087.11022053 4558929.245692376, -13612083.54806887 4558907.95663934, -13612075.53333716 4558865.6605253, -13612071.63709018 4558844.653200395, -13612067.18418175 4558819.839598609, -13612062.28633962 4558791.501373015, -13612053.93724031 4558745.540093932, -13612049.48446623 4558720.867956804, -13612062.17496642 4558720.586091247, -13612069.41050269 4558720.444906179, -13612082.54635829 4558718.89419038, -13612100.35740712 4558718.048131245, -13612113.15939938 4558717.484021174, -13612120.28378258 4558717.061180718, -13612141.65710028 4558716.21519884, -13612148.89257452 4558715.933292511, -13612160.13606304 4558715.369635211, -13612194.31078616 4558713.959928071, -13612205.66536867 4558713.536602789, -13612213.12405137 4558713.254663453, -13612235.72183121 4558712.97261744, -13612243.29160704 4558712.831609125, -13612256.09307373 4558712.408555384, -13612294.49883677 4558711.703685927, -13612294.94412094 4558711.70369703, -13612301.62314957 4558711.140055069, -13612307.18895524 4558709.166299813, -13612358.61863717 4558696.759697845, -13612482.96239142 4558667.012090526, -13612512.9074648 4558659.398919808, -13612564.33711008 4558646.710022656, -13612595.17277029 4558636.841424931, -13612615.98902524 4558632.188815352, -13612631.90792979 4558627.959346564, -13612835.39986374 4558575.93646815, -13612837.96023994 4558575.37231451, -13612888.0538813 4558562.824891889, -13612903.63883828 4558564.516907622, -13612910.87479134 4558593.27747745, -13612923.89921224 4558644.454409779, -13612927.0156667 4558651.785423871, -13612929.91035722 4558656.156212308, -13612932.02552194 4558662.9231863, -13612934.58562718 4558676.175589279, -13612935.03084 4558678.431355014, -13612939.2612761 4558698.169462127, -13612941.59865822 4558707.615377732, -13612944.27032359 4558718.330423968, -13612952.28562528 4558751.038861357, -13612954.95738169 4558761.894615762, -13612960.07773245 4558784.875015913, -13612975.7737973 4558853.958594042, -13612981.00591187 4558877.080137548, -13612985.01357847 4558891.461227532, -13612997.36983618 4558934.744397194, -13613001.59969459 4558949.266215206, -13613010.06026349 4558985.922614112, -13613025.64508916 4559053.315690403, -13613029.65269911 4559069.670387194, -13613034.10547217 4559092.792699891, -13613034.88459217 4559096.599626004, -13613043.2333462 4559133.538713095, -13613047.7975372 4559151.444600535, -13613061.8238987 4559205.162130469, -13613066.49919121 4559223.068410649, -13613069.05966234 4559232.9373507, -13613076.8521356 4559262.545644735, -13613079.52366168 4559272.415469433, -13613082.41781154 4559284.540632233, -13613091.10100367 4559321.198695961, -13613093.99524676 4559333.465157987, -13613097.00103997 4559345.590669821, -13613106.01746019 4559382.249197065, -13613109.13439378 4559394.515714735, -13613112.47406316 4559406.922909094, -13613122.27012424 4559442.312377082, -13613122.82695255 4559444.427334531, -13613126.16672084 4559456.975831304, -13613132.40020013 4559480.522023464, -13613151.43585708 4559551.583772036, -13613157.78120016 4559575.412370319, -13613164.34929129 4559600.50996, -13613176.59424444 4559647.038583061, -13613184.38632725 4559675.802176955, -13613191.288251 4559700.900254323, -13613197.29977514 4559725.292761971, -13613215.55603448 4559798.47115453, -13613221.67878791 4559823.004833055, -13613213.44070044 4559825.261384267, -13613206.76185571 4559826.388965008, -13613202.86576317 4559826.95335986, -13613146.2040479 4559836.682260987, -13613127.39126752 4559840.066220321, -13613107.4650047 4559843.168270897, -13613047.90888516 4559852.614867668, -13613028.09425848 4559855.858304336, -13613015.62644427 4559857.832394608, -13612978.55682708 4559864.036209978, -13612966.20011047 4559866.151202505, -13612955.9587433 4559867.701949101, -13612925.56903651 4559872.636912004, -13612915.43883291 4559874.470405471, -13612892.61803893 4559878.136016806, -13612824.15669033 4559889.134279542, -13612801.44751383 4559892.941232821, -13612793.32146153 4559893.928191978, -13612768.94228185 4559897.171529703, -13612760.92733705 4559898.299426902))"
423000,4991,4519,2641,220,12,1326,0,0,320,0,320,472,286,7,21,0,0,100,58,27,31,13188.0,"POLYGON ((-13610533.53535212 4563360.164831159, -13610558.02591041 4563354.804843615, -13610588.86111634 4563348.17575466, -13610606.89510288 4563345.636964278, -13610631.83042069 4563342.251644036, -13610656.65463545 4563338.866531753, -13610659.88338742 4563379.347094584, -13610661.99795953 4563399.658313886, -13610681.81325335 4563582.035307856, -13610682.25838814 4563585.138318501, -13610683.03763152 4563605.16765751, -13610683.26011413 4563629.005530887, -13610682.14711739 4563643.251762399, -13610679.25281666 4563655.664174518, -13610678.69637175 4563658.485276975, -13610673.79813045 4563685.425861828, -13610670.79230923 4563705.31453409, -13610668.45480743 4563720.971108806, -13610668.23212875 4563737.192454344, -13610669.01126278 4563750.028134339, -13610670.12439188 4563756.657641437, -13610673.68704714 4563769.493575918, -13610677.24899857 4563781.76544357, -13610699.51283106 4563868.090616759, -13610711.09013694 4563910.266102412, -13610712.75965717 4563915.908087725, -13610717.7690265 4563940.451489884, -13610719.55052732 4563958.507102097, -13610720.88622304 4563968.663168598, -13610725.00498938 4563999.131162752, -13610726.45239363 4564009.428312842, -13610727.56518176 4564023.392842059, -13610727.78823145 4564037.921898386, -13610728.34462427 4564070.505652802, -13610727.23145715 4564086.304597377, -13610723.55774595 4564123.402783974, -13610723.55792499 4564124.108189069, -13610721.55399711 4564136.520766451, -13610718.10299159 4564151.190910623, -13610715.76567768 4564156.551404405, -13610713.53888806 4564161.911628137, -13610708.19586767 4564172.209143535, -13610705.63575175 4564177.428293818, -13610700.95996262 4564190.405685852, -13610695.0598758 4564214.80872905, -13610694.39220043 4564219.463857101, -13610693.39056549 4564228.209220377, -13610693.05610178 4564237.09601792, -13610693.61299766 4564244.995529629, -13610695.95090976 4564257.690803041, -13610703.52025017 4564275.887605067, -13610709.53145443 4564285.197529406, -13610716.54487433 4564292.53299454, -13610727.78785637 4564301.843004624, -13610751.27658279 4564318.205920808, -13610782.22328801 4564339.788082181, -13610607.45162833 4564481.414627401, -13610547.22796798 4564528.671006581, -13610446.26091796 4564609.218531126, -13610439.80478057 4564614.861261716, -13610420.65738988 4564631.788908834, -13610414.31235587 4564637.572687419, -13610392.93925267 4564653.512929507, -13610328.93013756 4564701.616469663, -13610320.69244448 4564707.964225736, -13610307.2227512 4564716.851397641, -13610289.63443936 4564731.522233068, -13610237.09200589 4564775.676048827, -13610219.61462223 4564790.488472906, -13610198.46405241 4564808.26287441, -13610135.34575295 4564861.445610817, -13610114.30659552 4564879.361019317, -13610111.85726425 4564882.464316228, -13610109.29714912 4564884.298287855, -13610093.37835521 4564896.712589419, -13610029.48068387 4564946.791886639, -13610008.21875201 4564963.579460915, -13610035.26926398 4564988.407447834, -13610055.08439084 4565006.605569213, -13610113.63858115 4565067.406983688, -13610130.44774714 4565084.759017561, -13610139.01904859 4565095.056706218, -13610106.6252467 4565134.133919156, -13610099.72374776 4565140.482080722, -13610085.25192304 4565156.705595962, -13610040.61268539 4565207.35069176, -13610002.09634597 4565254.751192423, -13609999.20189932 4565257.854462859, -13609990.51934465 4565259.124213552, -13609982.5038866 4565262.933388151, -13609980.27741649 4565264.061709117, -13609949.55344456 4565282.965724209, -13609935.30446691 4565289.172949713, -13609932.63301526 4565290.442476609, -13609925.73119715 4565292.982268838, -13609918.60689347 4565293.969711656, -13609912.92919907 4565294.675155016, -13609908.69918134 4565294.675206132, -13609907.47473287 4565294.675175673, -13609901.12970857 4565294.674962285, -13609896.00891132 4565293.405136619, -13609885.87849637 4565291.289195647, -13609862.27926547 4565276.476488231, -13609849.36610168 4565264.344310099, -13609838.12274165 4565250.800757524, -13609821.75895762 4565231.050729694, -13609815.41327196 4565223.432675869, -13609809.17974323 4565215.250793944, -13609783.01927272 4565180.546416765, -13609775.0046743 4565172.223313997, -13609770.77424781 4565169.401983434, -13609770.10641252 4565168.978403768, -13609758.97476392 4565165.02860991, -13609753.74257602 4565165.028607771, -13609744.94819162 4565165.028769794, -13609738.38064585 4565166.157268331, -13609722.01663093 4565171.800257031, -13609715.1144767 4565175.608929359, -13609700.30915101 4565187.45912504, -13609693.63023627 4565194.371831285, -13609630.28903699 4565260.675945783, -13609605.79899626 4565283.953204392, -13609599.56517297 4565288.46751676, -13609592.77474844 4565289.596441506, -13609587.54249913 4565289.59635443, -13609584.53683161 4565288.890858993, -13609579.08200495 4565286.351428314, -13609576.52163761 4565283.812267084, -13609552.14290585 4565249.248930223, -13609547.13334405 4565240.361461638, -13609543.34866253 4565230.486521187, -13609514.96245316 4565155.012622403, -13609512.62440926 4565148.805428983, -13609505.61149001 4565130.607274249, -13609503.38517239 4565124.681917259, -13609500.04514587 4565115.93549167, -13609496.26046333 4565109.587425537, -13609490.80570972 4565102.533677323, -13609484.68325056 4565091.67146233, -13609482.67976889 4565086.02826394, -13609482.23436385 4565082.924758034, -13609481.0098645 4565073.896068574, -13609481.67756608 4565065.008988966, -13609483.23632294 4565059.930445211, -13609499.71159419 4565030.728660828, -13609507.16997683 4565015.634362238, -13609510.1756035 4565004.207389637, -13609511.84553077 4564991.511003107, -13609509.73023253 4564943.406077474, -13609507.61526713 4564893.467649119, -13609506.39054733 4564882.888039716, -13609506.16816935 4564881.618386952, -13609506.16813458 4564881.335747325, -13609500.7130261 4564870.896779473, -13609489.47007506 4564853.968564302, -13609483.4585043 4564844.658000099, -13609476.77966895 4564834.642366482, -13609466.64964564 4564822.93358857, -13609460.08166933 4564815.175376221, -13609452.95713713 4564807.980841714, -13609432.47424461 4564791.757885053, -13609416.66713873 4564782.870596603, -13609409.31980271 4564779.485284741, -13609404.75594458 4564778.074420942, -13609398.9670947 4564776.381396234, -13609389.83918438 4564776.522762854, -13609381.71285547 4564780.895681842, -13609423.68026828 4564739.704080988, -13609411.32400646 4564742.666543497, -13609400.9713095 4564752.823660556, -13609379.93171585 4564780.049508784, -13609372.02789823 4564786.961643226, -13609367.12974698 4564791.334698027, -13609362.23177594 4564792.604468331, -13609356.88874523 4564793.168651165, -13609348.31670949 4564791.757648434, -13609326.16437508 4564782.729491366, -13609315.36645916 4564777.510181543, -13609306.34933484 4564774.970749681, -13609295.21744148 4564773.560328173, -13609273.28770283 4564772.149592466, -13609254.58601984 4564774.547715749, -13609244.45611907 4564776.381302569, -13609235.43878728 4564776.94565938, -13609227.53509008 4564775.53535056, -13609219.8544782 4564771.726135393, -13609211.83899415 4564763.967616739, -13609196.6996933 4564742.948637604, -13609155.28894987 4564688.92027156, -13609143.37800815 4564673.261890223, -13609137.58914584 4564664.939434573, -13609128.79465684 4564654.077143107, -13609114.9914506 4564630.378281399, -13609106.64230204 4564605.550471255, -13609105.97417507 4564601.600837212, -13609103.19126817 4564581.287908618, -13609103.19124068 4564575.221637134, -13609103.19135219 4564553.356658229, -13609104.74965053 4564542.636108621, -13609107.97814934 4564535.01848391, -13609113.54418776 4564526.69593037, -13609118.66495976 4564521.053063168, -13609121.89312419 4564515.97510703, -13609136.47606687 4564499.752537343, -13609137.36647236 4564498.906089952, -13609146.04965984 4564486.91613412, -13609150.83626663 4564478.734365994, -13609151.61539494 4564476.195258561, -13609152.95095872 4564471.822397559, -13609153.28509531 4564463.499567599, -13609150.50197384 4564452.637779032, -13609146.94016956 4564443.045567979, -13609141.81930282 4564436.133223834, -13609135.02854915 4564429.080441385, -13609130.90973887 4564426.682172819, -13609126.90262385 4564424.566284325, -13609116.88358456 4564420.898506114, -13609103.85927978 4564417.653938475, -13609093.06105686 4564415.961690769, -13609083.04255175 4564411.729778062, -13609076.58593841 4564406.933237331, -13609067.34668601 4564401.149706649, -13609056.54831583 4564397.623212007, -13609044.303191 4564397.764349475, -13609023.82043736 4564404.676521289, -13608993.87553727 4564423.437683094, -13608976.51004387 4564434.440373593, -13608968.82868199 4564437.826071683, -13608952.46462029 4564440.929528906, -13608948.23494952 4564440.929763786, -13608943.55917236 4564440.788519919, -13608936.21243614 4564439.800744534, -13608924.85748939 4564436.838871924, -13608904.04109781 4564427.10517078, -13608889.45826552 4564419.064845498, -13608875.76591953 4564410.742197878, -13608840.58853894 4564385.91505836, -13608778.69487569 4564347.687709047, -13608764.44611195 4564339.647106884, -13608749.5292041 4564333.440440673, -13608746.85753341 4564321.02686395, -13608693.86961463 4564070.506080117, -13608695.53937993 4564069.659713018, -13608702.88655284 4564063.734943652, -13608711.90315778 4564051.886420514, -13608725.48411322 4564038.062720676, -13608736.39367328 4564032.98483411, -13608748.74988503 4564030.586890738, -13608774.91040829 4564032.984773742, -13608801.40440013 4564037.921967347, -13608809.7532735 4564043.281857262, -13608817.32283282 4564049.20640685, -13608826.11694361 4564058.374916388, -13608841.47947138 4564070.646875339, -13608866.30351961 4564079.6746929, -13608882.77858669 4564082.354592114, -13608898.02970982 4564082.354600246, -13608915.95202774 4564080.238756172, -13608941.22142863 4564072.762599461, -13608985.52659295 4564053.861040272, -13609003.6718743 4564042.153319688, -13609016.69623938 4564032.843766938, -13609023.70917127 4564024.944648659, -13609030.05438787 4564016.903995904, -13609037.84686883 4564005.196415876, -13609045.63946348 4563994.89963262, -13609069.12769995 4563964.149215505, -13609077.0313431 4563953.992933098, -13609072.57828068 4563945.388850566, -13609071.57645887 4563942.42649826, -13609068.57090878 4563932.693892093, -13609062.89389234 4563903.636276895, -13609060.4446474 4563890.659280047, -13609083.48780891 4563884.594069281, -13609152.6171966 4563866.962228087, -13609155.40009668 4563866.256904849, -13609162.07947868 4563863.153243789, -13609167.53383812 4563858.498524995, -13609172.65476975 4563852.433215742, -13609166.30957569 4563842.559458689, -13609160.07581069 4563835.789032593, -13609150.05699625 4563829.01849594, -13609129.24027013 4563817.451704207, -13609128.68364775 4563817.169765817, -13609121.44793008 4563811.386704767, -13609117.1062988 4563805.885503195, -13609114.4348722 4563798.973816589, -13609111.8741975 4563788.676853891, -13609110.09306523 4563774.712818685, -13609107.19863044 4563697.133524653, -13609108.08934311 4563677.386217934, -13609109.42547358 4563668.217965342, -13609114.21216538 4563658.767409346, -13609121.67063098 4563648.893844173, -13609129.35174002 4563643.674774325, -13609132.35726898 4563642.405478249, -13609147.05117801 4563637.045424127, -13609163.41516492 4563634.929292631, -13609170.31691342 4563635.070582547, -13609177.66432226 4563636.76348896, -13609183.67531737 4563639.020015203, -13609192.69249723 4563646.072390277, -13609197.92418401 4563653.689305895, -13609203.37894974 4563664.268520665, -13609204.60345836 4563666.524910311, -13609207.49776793 4563674.423968955, -13609213.50919146 4563695.722721563, -13609229.42755806 4563727.318466538, -13609247.0161446 4563757.081010995, -13609248.68623224 4563759.902207493, -13609258.70445896 4563771.468378135, -13609268.946254 4563780.072376982, -13609268.38944198 4563768.36535381, -13609268.61202046 4563752.144000934, -13609267.94427016 4563741.706140905, -13609269.0571988 4563734.653294032, -13609269.72508216 4563731.55053529, -13609275.84808107 4563716.598573619, -13609285.42165109 4563696.710389064, -13609291.87780109 4563685.990522981, -13609295.32885686 4563675.411304127, -13609296.44204125 4563661.165189763, -13609296.21914255 4563650.304222294, -13609295.21741578 4563638.879240409, -13609291.76644086 4563616.310598274, -13609292.76863356 4563607.706620466, -13609295.2174532 4563600.795015421, -13609303.3438705 4563585.561823301, -13609309.80022779 4563567.788971401, -13609330.83987397 4563578.509098839, -13609336.51677721 4563583.304566881, -13609341.19242188 4563590.075383361, -13609347.42657526 4563609.399155156, -13609352.7694284 4563616.874983261, -13609360.11690596 4563623.504199916, -13609376.81457464 4563629.710683313, -13609379.70921372 4563630.275076327, -13609382.38055769 4563630.980125312, -13609395.07105158 4563628.017822593, -13609401.5274024 4563624.49181224, -13609405.53497563 4563618.84951416, -13609407.87259611 4563611.656094464, -13609408.42956229 4563610.24581636, -13609406.53683833 4563586.407744061, -13609406.8707883 4563578.508938394, -13609410.98988851 4563567.647962023, -13609411.32366526 4563567.225014866, -13609420.78596054 4563557.633391372, -13609430.69357236 4563555.517741363, -13609436.37043989 4563555.518033141, -13609442.38197795 4563557.49236427, -13609447.39108303 4563561.018703545, -13609448.17059377 4563562.429386505, -13609450.95354204 4563567.083753652, -13609453.06868723 4563574.982720765, -13609456.18575015 4563594.447903748, -13609460.63848733 4563607.84780893, -13609464.31206016 4563613.912627432, -13609470.21165281 4563617.721275488, -13609482.56843062 4563620.119405401, -13609498.15285753 4563621.106308392, -13609506.50203454 4563620.260117678, -13609514.6285042 4563619.695887169, -13609534.99945895 4563612.925373415, -13609532.32789022 4563602.628951772, -13609531.66020245 4563594.448089664, -13609531.77161387 4563588.664738474, -13609533.99797422 4563572.867007026, -13609538.67323037 4563563.980654052, -13609544.23929118 4563557.915458344, -13609551.809154 4563553.543039157, -13609557.15245462 4563551.427361269, -13609567.50489274 4563544.938790401, -13609568.39581076 4563544.515719294, -13609578.30312035 4563532.808579845, -13609580.97494032 4563525.192231618, -13609581.97666169 4563515.036268941, -13609580.08417376 4563507.137437419, -13609565.83523398 4563470.746870554, -13609565.8351499 4563466.23325674, -13609567.61646084 4563461.860893931, -13609572.06910666 4563458.334249264, -13609577.07842086 4563455.513410291, -13609646.43027084 4563422.790230809, -13609660.56808914 4563416.866204469, -13609681.49624125 4563409.954677903, -13609695.29980882 4563408.826415808, -13609704.98460485 4563411.083328514, -13609705.20737139 4563411.224119197, -13609755.96886564 4563440.421421877, -13609773.44611574 4563445.075641524, -13609785.91371606 4563443.242106103, -13609800.94191167 4563434.073929364, -13609801.49843677 4563433.791763658, -13609808.95675312 4563427.86801959, -13609815.97026524 4563419.264033691, -13609821.86981546 4563409.249608642, -13609825.54383802 4563400.363286887, -13609826.99100199 4563391.477520221, -13609828.32658934 4563386.399667106, -13609829.88523858 4563376.526276503, -13609831.22066968 4563357.202941504, -13609830.44183891 4563336.609970889, -13609829.21702248 4563299.655459866, -13609854.26394938 4563315.029583929, -13609858.82800048 4563317.568152684, -13609886.88068383 4563333.506779875, -13609897.90108481 4563340.841450675, -13609901.90869597 4563347.18835979, -13609902.46549476 4563351.701782038, -13609901.79736169 4563361.857417096, -13609893.78247274 4563389.784584327, -13609893.78262372 4563397.119584805, -13609895.11814159 4563401.491640946, -13609898.34642951 4563404.453767178, -13609898.68025932 4563404.45356657, -13609902.13138257 4563404.736202604, -13609909.14442708 4563403.607327695, -13609929.62725802 4563392.323481064, -13609941.42692232 4563383.155745116, -13609948.21773386 4563375.539028215, -13609951.0004936 4563362.562786386, -13609950.77817851 4563355.510355482, -13609948.77399636 4563345.636637928, -13609946.43647523 4563338.443238956, -13609940.87065049 4563328.147026221, -13609917.15938506 4563296.552135743, -13609812.8532512 4563157.480950454, -13609803.61380817 4563136.324351468, -13609798.93835157 4563121.091144733, -13609796.93433612 4563097.53709629, -13609799.27209187 4563083.291749864, -13609805.61762223 4563070.59774233, -13609812.07365654 4563064.673641739, -13609822.09291376 4563059.031943108, -13609829.10565797 4563057.480414548, -13609844.57906679 4563056.916182459, -13609869.8488071 4563056.352206607, -13609885.98989584 4563056.07010361, -13609898.3465479 4563054.51877622, -13609903.80144302 4563050.710653784, -13609907.58619059 4563047.325123766, -13609910.70322055 4563043.517254176, -13609914.26521486 4563036.888174679, -13609916.15770344 4563031.105582402, -13609916.93666468 4563022.924698041, -13609913.26309598 4562998.101388128, -13609909.58988597 4562978.35500118, -13609908.58798008 4562972.572267895, -13609905.80507478 4562955.647454818, -13609904.91427954 4562950.005768465, -13609924.61789563 4562947.184673148, -13609969.2572007 4562940.978802538, -13609983.61746052 4562938.01724475, -13609984.61887655 4562937.875912295, -13609989.85113116 4562935.055069189, -13609995.52837143 4562929.69562618, -13609999.53586615 4562923.772024221, -13610021.57696057 4562922.502411345, -13610087.9236186 4562919.258524322, -13610110.07639968 4562918.271053576, -13610116.08747269 4562927.720834543, -13610134.12135253 4562956.21150686, -13610140.24357883 4562965.80234099, -13610157.49822117 4562991.049129671, -13610186.33003041 4563033.220823044, -13610209.15054544 4563067.353412808, -13610216.05233965 4563077.649532177, -13610220.50498842 4563086.958890082, -13610223.73325325 4563095.280337207, -13610229.96750986 4563103.178873027, -13610236.53519955 4563133.644526869, -13610237.3146349 4563137.029236256, -13610238.31621018 4563148.454157673, -13610238.20483095 4563157.904122145, -13610236.53502804 4563181.740845448, -13610231.8596449 4563208.116002035, -13610226.85028202 4563228.427078934, -13610220.95040987 4563259.175153609, -13610213.04698752 4563300.92468485, -13610210.26380723 4563315.734942027, -13610208.59380133 4563322.505170132, -13610197.46191794 4563369.61470864, -13610196.68261833 4563372.435654912, -13610193.34330802 4563386.822842869, -13610188.33401311 4563408.262357055, -13610206.47915383 4563407.838911972, -13610207.03569398 4563407.698025121, -13610229.52192647 4563405.441205647, -13610262.91807616 4563401.068434231, -13610281.61937701 4563398.811799278, -13610307.00031507 4563395.003448615, -13610383.36582315 4563383.86067739, -13610408.85780428 4563380.193688749, -13610423.32932609 4563378.359816055, -13610433.79320249 4563376.52623729, -13610508.60012773 4563364.255273124, -13610533.53535212 4563360.164831159))"
423100,4272,3784,1984,797,0,660,43,0,300,0,300,488,118,0,0,9,0,206,155,102,53,15856.0,"POLYGON ((-13609741.83117365 4560912.990878151, -13609709.54892838 4560917.926352066, -13609613.03466323 4560933.015084832, -13609609.69497972 4560933.579197774, -13609580.86337673 4560938.091747427, -13609528.32075656 4560946.693741234, -13609370.91454468 4560972.781327844, -13609318.48324878 4560981.665137244, -13609315.36626487 4560955.013293333, -13609306.23809076 4560875.058232788, -13609303.23281223 4560848.547673283, -13609299.55916135 4560824.011245863, -13609288.87205253 4560750.402118465, -13609285.31010671 4560726.007503355, -13609283.41785731 4560700.20226702, -13609281.74790372 4560675.806933422, -13609277.85144325 4560644.643489175, -13609274.06671459 4560623.633051306, -13609269.61403298 4560598.533273908, -13609264.15912358 4560574.279373473, -13609253.47267692 4560526.195020715, -13609250.57827438 4560501.095392692, -13609247.90659773 4560476.277844855, -13609277.40615364 4560471.060325433, -13609366.35058441 4560455.549822439, -13609395.96166513 4560450.473556717, -13609416.44421766 4560446.807036745, -13609478.0040541 4560436.372606525, -13609498.59819174 4560432.847509664, -13609505.94528675 4560431.719030338, -13609528.32034341 4560428.758295538, -13609535.77907713 4560427.770804503, -13609564.6109273 4560422.835958463, -13609615.70657702 4560414.093382427, -13609651.10582488 4560408.453009109, -13609680.04928814 4560404.081491875, -13609695.74524905 4560402.389304852, -13609709.21449399 4560401.120256858, -13609742.94446639 4560395.761924407, -13609758.75190989 4560393.364807355, -13609767.87986779 4560389.275898432, -13609807.2869781 4560382.648415769, -13609954.34015338 4560358.254107583, -13610003.4323518 4560350.216602391, -13610053.52612229 4560341.615505164, -13610165.84748267 4560322.579343175, -13610197.23918671 4560317.362281433, -13610204.02971981 4560316.234048923, -13610254.34599577 4560308.337774562, -13610305.10808552 4560300.300676006, -13610457.50448329 4560276.611421202, -13610508.37735705 4560268.714910004, -13610514.61140652 4560291.276237858, -13610514.72279811 4560292.686267828, -13610518.28494236 4560318.349081088, -13610520.95663443 4560335.552270242, -13610525.85472074 4560367.701928716, -13610529.75051223 4560392.800804537, -13610533.86970202 4560418.46425572, -13610546.44835937 4560495.455006777, -13610550.67871746 4560521.259697803, -13610554.68638255 4560546.92314538, -13610566.93112777 4560624.338250502, -13610571.04996075 4560650.142940811, -13610575.39179997 4560663.256930167, -13610576.28224714 4560673.69170023, -13610578.84277537 4560701.330349704, -13610581.29177447 4560722.340796455, -13610584.5197613 4560747.440944006, -13610587.7481924 4560771.977239693, -13610574.27834318 4560774.6566837, -13610537.65462136 4560781.142895789, -13610387.37322133 4560807.935554834, -13610337.39033173 4560816.960453716, -13610287.07396652 4560824.998193828, -13610199.35418331 4560839.09934172, -13610136.12498041 4560849.111696807, -13610085.91996963 4560857.290059458, -13610035.04678673 4560865.327897299, -13610027.14303615 4560866.597068629, -13609882.42783828 4560889.018438393, -13609831.55489466 4560896.915177704, -13609813.52107603 4560900.017684575, -13609759.7539252 4560909.606789738, -13609741.83117365 4560912.990878151))"
423200,3004,2055,896,634,0,181,109,0,235,0,235,949,434,11,17,0,0,326,161,9,152,5588.0,"POLYGON ((-13609178.22080962 4559595.57487086, -13609179.33378807 4559607.84156955, -13609182.56240291 4559645.91096484, -13609182.78499029 4559650.281760923, -13609183.67541037 4559663.39480463, -13609184.0096163 4559667.765360712, -13609185.79069746 4559685.953989252, -13609191.24505292 4559740.802311694, -13609193.13778577 4559759.132641013, -13609194.25065736 4559780.141082027, -13609197.59045366 4559843.450313353, -13609198.81497499 4559864.599927451, -13609199.59423862 4559876.443931963, -13609202.2657993 4559912.399604748, -13609203.15613496 4559924.384664075, -13609203.71297074 4559933.267494747, -13609205.71662397 4559959.916991128, -13609206.3845292 4559968.940853462, -13609209.94690875 4560010.677687, -13609220.74472696 4560136.170287417, -13609224.41828046 4560178.048785233, -13609224.97515946 4560187.073086034, -13609226.64466268 4560214.146025618, -13609227.31259939 4560223.170105083, -13609231.43144039 4560273.791054717, -13609243.78817925 4560425.655930063, -13609247.90659773 4560476.277844855, -13609222.41485488 4560478.110901685, -13609145.82685649 4560484.033144275, -13609120.44614551 4560486.007531984, -13609094.61952785 4560488.263652856, -13609017.47562263 4560495.032047519, -13608991.76060158 4560497.42892845, -13608983.41159278 4560498.134349934, -13608958.3645953 4560500.53138027, -13608950.12723462 4560501.518480203, -13608932.31581248 4560502.928285797, -13608929.19888715 4560503.210285842, -13608879.21680243 4560505.325547088, -13608861.51694112 4560506.171659122, -13608761.99724559 4560514.914359331, -13608646.44730177 4560524.502767414, -13608631.86489808 4560525.067148643, -13608559.61815738 4560529.578970176, -13608522.99445454 4560532.117453001, -13608475.68324634 4560535.501440406, -13608469.56096459 4560535.783547375, -13608413.12180097 4560531.553261485, -13608376.60893879 4560529.015301961, -13608373.15817564 4560526.899851412, -13608363.02799552 4560520.554725304, -13608359.68829068 4560518.439600991, -13608335.75493176 4560516.042432325, -13608263.9537818 4560508.851160942, -13608240.13152799 4560506.594792828, -13608237.12549735 4560473.598892099, -13608228.22028725 4560375.034212871, -13608225.32595701 4560342.179172185, -13608222.54273477 4560311.581263716, -13608214.19374216 4560219.786358079, -13608211.52220832 4560189.187994862, -13608207.84870793 4560176.215733742, -13608197.1619957 4560137.721516069, -13608193.71120664 4560124.890091815, -13608176.67920786 4560043.672339649, -13608158.31137737 4559878.418273665, -13608147.06847182 4559776.757166731, -13608146.28928824 4559766.323423329, -13608143.17236518 4559751.800714826, -13608134.04375224 4559708.654830152, -13608131.03848005 4559694.273212017, -13608133.1536465 4559660.715311183, -13608139.61008882 4559560.04372187, -13608141.83623671 4559526.627825386, -13608135.82495221 4559521.833705357, -13608134.82322736 4559518.591160978, -13608133.70989217 4559515.065786652, -13608131.81772493 4559481.650279807, -13608131.26121224 4559469.383573214, -13608083.95024255 4559484.188162199, -13608067.92002817 4559489.405076104, -13608067.2520581 4559489.686708404, -13607978.19640782 4559371.815645019, -13607944.5779052 4559327.261573614, -13607951.36857966 4559329.376696735, -13607963.27975335 4559332.055064925, -13607981.98161485 4559337.97677005, -13607985.87778898 4559339.245980135, -13608000.46027228 4559346.295507725, -13608035.19229324 4559371.956213306, -13608059.79382338 4559383.659152525, -13608073.04103412 4559388.170754519, -13608088.29158452 4559392.118791875, -13608121.24195326 4559400.719225988, -13608126.02879545 4559401.988201722, -13608151.85527385 4559404.948809557, -13608159.64767674 4559404.949263775, -13608173.00593099 4559405.23113082, -13608206.73577005 4559402.552251467, -13608260.72559206 4559399.027351964, -13608281.31984856 4559397.758090182, -13608294.56646913 4559397.617443359, -13608325.73599226 4559394.938553051, -13608419.57818471 4559387.324904539, -13608450.97031809 4559384.927647689, -13608467.66831119 4559383.377123335, -13608517.87334179 4559379.28841239, -13608534.68294178 4559377.878214289, -13608554.27486484 4559376.186282832, -13608613.05175024 4559371.392767538, -13608632.75527146 4559369.841692708, -13608648.11730045 4559368.572862723, -13608694.53764826 4559364.90675152, -13608710.01071634 4559363.77882901, -13608724.81638591 4559362.650640434, -13608769.23284126 4559359.830925557, -13608784.14956216 4559358.984895968, -13608805.07794536 4559357.716148457, -13608866.19232425 4559354.191254537, -13608868.08458835 4559353.90915096, -13608889.12393463 4559351.935473557, -13608899.14263853 4559349.397745224, -13608921.29550667 4559343.898985611, -13608929.1992338 4559341.078855179, -13608939.1062305 4559337.695007098, -13608972.61338166 4559338.963857686, -13608979.29306277 4559339.24580311, -13609004.3397992 4559339.528053369, -13609027.04880574 4559338.4001393, -13609043.74656472 4559336.002933974, -13609048.97908447 4559334.452445058, -13609059.55421644 4559327.543303371, -13609063.56169441 4559318.943008131, -13609064.22966556 4559313.444404532, -13609064.67463052 4559310.060394717, -13609063.67273228 4559302.164932312, -13609061.55772618 4559295.819932164, -13609057.6615147 4559289.757393803, -13609051.98420447 4559284.963739484, -13609047.7543629 4559279.465213099, -13609068.01440208 4559270.723487227, -13609073.02360842 4559268.608509952, -13609080.92726403 4559266.070771138, -13609098.85010575 4559261.417718447, -13609119.11025154 4559259.726103747, -13609130.57598807 4559259.162352829, -13609131.35497738 4559259.021078609, -13609152.72831934 4559256.765362056, -13609155.51162891 4559296.524852335, -13609163.86053868 4559415.946602479, -13609166.75498043 4559455.848259325, -13609169.87188448 4559493.775535374, -13609178.22080962 4559595.57487086))"
423300,3764,3292,1565,1136,29,299,0,0,263,11,252,472,216,29,9,4,0,137,77,77,0,10941.0,"POLYGON ((-13611319.33962285 4563926.628336001, -13611313.66272775 4563932.693836341, -13611307.98516726 4563934.809597975, -13611301.9738901 4563935.514821028, -13611294.73797345 4563935.091433361, -13611291.73248532 4563934.104485886, -13611288.50416108 4563932.834894214, -13611284.27434803 4563929.872641656, -13611163.71498515 4564024.944595098, -13611051.72763409 4564118.183386483, -13611031.5790961 4564133.840875493, -13610993.28512865 4564163.745294189, -13610970.35323592 4564178.979799934, -13610949.53628096 4564192.944816694, -13610934.06311206 4564208.6023889, -13610908.12547429 4564235.262223124, -13610885.75041103 4564252.330635531, -13610868.82985527 4564265.449214344, -13610851.46418704 4564280.260588078, -13610799.47802015 4564324.835699535, -13610782.22328801 4564339.788082181, -13610751.27658279 4564318.205920808, -13610727.78785637 4564301.843004624, -13610716.54487433 4564292.53299454, -13610709.53145443 4564285.197529406, -13610703.52025017 4564275.887605067, -13610695.95090976 4564257.690803041, -13610693.61299766 4564244.995529629, -13610693.05610178 4564237.09601792, -13610693.39056549 4564228.209220377, -13610694.39220043 4564219.463857101, -13610695.0598758 4564214.80872905, -13610700.95996262 4564190.405685852, -13610705.63575175 4564177.428293818, -13610708.19586767 4564172.209143535, -13610713.53888806 4564161.911628137, -13610715.76567768 4564156.551404405, -13610718.10299159 4564151.190910623, -13610721.55399711 4564136.520766451, -13610723.55792499 4564124.108189069, -13610723.55774595 4564123.402783974, -13610727.23145715 4564086.304597377, -13610728.34462427 4564070.505652802, -13610727.78823145 4564037.921898386, -13610727.56518176 4564023.392842059, -13610726.45239363 4564009.428312842, -13610725.00498938 4563999.131162752, -13610720.88622304 4563968.663168598, -13610719.55052732 4563958.507102097, -13610717.7690265 4563940.451489884, -13610712.75965717 4563915.908087725, -13610711.09013694 4563910.266102412, -13610699.51283106 4563868.090616759, -13610677.24899857 4563781.76544357, -13610673.68704714 4563769.493575918, -13610670.12439188 4563756.657641437, -13610669.01126278 4563750.028134339, -13610668.23212875 4563737.192454344, -13610668.45480743 4563720.971108806, -13610670.79230923 4563705.31453409, -13610673.79813045 4563685.425861828, -13610678.69637175 4563658.485276975, -13610679.25281666 4563655.664174518, -13610682.14711739 4563643.251762399, -13610683.26011413 4563629.005530887, -13610683.03763152 4563605.16765751, -13610682.25838814 4563585.138318501, -13610681.81325335 4563582.035307856, -13610661.99795953 4563399.658313886, -13610659.88338742 4563379.347094584, -13610656.65463545 4563338.866531753, -13610681.5903488 4563334.917044863, -13610756.39744478 4563323.351401076, -13610781.44420419 4563319.543281057, -13610805.82315032 4563315.170365407, -13610879.18267362 4563302.335061966, -13610892.76349688 4563300.078790375, -13610903.67281164 4563298.668146069, -13610929.16482626 4563294.436425078, -13611006.08686598 4563282.024708509, -13611031.69049206 4563277.934344484, -13611061.85806122 4563273.13838118, -13611152.47172229 4563258.892716034, -13611168.72468998 4563256.495163595, -13611182.75091799 4563254.379307752, -13611203.34496094 4563249.019889306, -13611205.12617831 4563248.596232588, -13611266.35147323 4563239.428380001, -13611287.39109909 4563236.466344205, -13611297.18704929 4563251.135069357, -13611297.63265698 4563251.55844856, -13611305.53637289 4563259.45694751, -13611319.00573952 4563269.18899241, -13611334.47933857 4563277.511150883, -13611339.15459891 4563279.344582308, -13611354.2942197 4563285.268325346, -13611369.99021873 4563276.241662055, -13611417.18976284 4563249.30145687, -13611432.99678456 4563240.415750125, -13611454.37052202 4563228.00391691, -13611518.71312839 4563191.049701598, -13611531.62604517 4563183.715576876, -13611539.86373713 4563178.073678724, -13611545.20686117 4563185.689945659, -13611548.9916827 4563190.767862729, -13611577.15595128 4563228.426936737, -13611586.61776092 4563240.980168488, -13611590.73649829 4563246.198568509, -13611601.42344798 4563258.046869493, -13611601.64628347 4563258.328915936, -13611630.81186691 4563294.436468201, -13611644.61509655 4563313.196109425, -13611649.84713366 4563320.389374246, -13611657.64003263 4563333.083522017, -13611659.9776632 4563337.173678014, -13611666.99060835 4563349.586024156, -13611669.43937666 4563353.817778157, -13611680.6828868 4563376.526495626, -13611688.92044495 4563393.170251347, -13611704.17143349 4563428.150179532, -13611711.18469031 4563447.614474224, -13611711.29587425 4563447.896797564, -13611719.08807391 4563472.721752126, -13611727.88218593 4563503.470340185, -13611729.10672531 4563507.561028698, -13611736.00843648 4563536.758384015, -13611742.35375664 4563566.378821091, -13611745.69363251 4563586.83131233, -13611747.14083535 4563598.679387176, -13611749.36703574 4563616.028905203, -13611751.70462586 4563630.980027606, -13611754.82169125 4563651.150588123, -13611764.17239157 4563711.661920618, -13611767.28950323 4563731.832632751, -13611760.6105383 4563736.910486984, -13611746.13875963 4563733.948232275, -13611745.91596255 4563733.806908741, -13611738.56922415 4563733.806890437, -13611715.85999143 4563736.486947433, -13611705.06171074 4563738.743765153, -13611690.70179135 4563739.59008739, -13611678.45664326 4563739.026100959, -13611655.97000625 4563738.038995033, -13611640.38496937 4563752.990132222, -13611635.15299234 4563758.209635718, -13611625.69128844 4563764.133561763, -13611612.66680739 4563770.339756237, -13611586.50665491 4563780.918850052, -13611567.91612142 4563788.535797406, -13611418.41417989 4563847.073525559, -13611405.27829835 4563849.471383532, -13611368.98808589 4563862.307174263, -13611351.95655883 4563870.065283168, -13611337.37361765 4563877.964394427, -13611327.24346635 4563884.170641912, -13611313.21713383 4563897.712047029, -13611316.66802985 4563900.251124432, -13611320.78689181 4563907.303515304, -13611322.01158832 4563915.908217965, -13611321.00945099 4563921.268315424, -13611319.33962285 4563926.628336001))"
423400,5069,4166,2394,675,0,591,0,0,506,0,506,903,424,26,0,0,0,276,177,63,114,18740.0,"POLYGON ((-13613849.40921613 4562274.576241522, -13613847.96202959 4562268.793749036, -13613822.91533901 4562168.660927163, -13613814.56640746 4562135.377707221, -13613771.81976282 4561970.513577386, -13613761.1326532 4561808.049372406, -13613729.40688957 4561801.139200844, -13613714.82409545 4561755.728443876, -13613714.49027408 4561754.600260193, -13613678.31141476 4561611.460018138, -13613672.41104672 4561588.049748336, -13613666.28868148 4561563.793619493, -13613659.94356271 4561539.396862683, -13613641.13066876 4561466.488289025, -13613634.89681132 4561442.23214691, -13613627.99476523 4561416.707522701, -13613607.62339358 4561340.555782871, -13613600.83261845 4561315.172362396, -13613599.38584779 4561309.672339028, -13613591.37085276 4561279.494170676, -13613563.31827863 4561173.025024455, -13613553.96732801 4561137.48882294, -13613544.95053646 4561098.285710569, -13613517.89963611 4560981.101003526, -13613512.44512302 4560957.269354265, -13613508.3263175 4560942.322010394, -13613530.47871463 4560937.245501396, -13613557.52924649 4560931.322592515, -13613596.93654306 4560921.310518734, -13613610.29502935 4560918.067476012, -13613618.97790647 4560915.388244875, -13613621.20434539 4560914.542133446, -13613627.99502203 4560912.567994184, -13613630.33259567 4560911.862848809, -13613656.04705763 4560905.235215014, -13613686.43741929 4560897.620440703, -13613733.30275843 4560885.91615641, -13613749.33303411 4560881.968027419, -13613759.12921482 4560879.147294373, -13613782.50595898 4560873.225108808, -13613852.74889151 4560855.59808703, -13613876.23724047 4560849.816670511, -13613901.06145504 4560843.611805896, -13613919.54027871 4560839.099760602, -13613975.53432514 4560824.716062215, -13614000.35834047 4560818.370278548, -13614024.96020413 4560812.025046081, -13614098.87644506 4560793.552056663, -13614113.34788443 4560790.026848667, -13614123.36672048 4560786.501723931, -13614126.2609742 4560802.858868831, -13614128.93251192 4560815.268075512, -13614131.71534231 4560826.126503902, -13614145.07377269 4560876.608996486, -13614153.75643796 4560914.541993423, -13614161.43780965 4560943.5911769, -13614171.90163938 4560982.652550835, -13614180.47346965 4561017.765428871, -13614190.82618887 4561060.352217483, -13614201.6241955 4561101.669962849, -13614207.30146194 4561122.822576157, -13614216.87470511 4561157.795318295, -13614229.23119877 4561207.71580479, -13614266.41178322 4561357.337594003, -13614278.87988923 4561407.39994173, -13614291.57030372 4561456.616545523, -13614329.97545389 4561604.267305377, -13614342.777404 4561653.48503847, -13614344.33562333 4561659.83135205, -13614350.45828608 4561685.638499223, -13614373.38982002 4561782.523580481, -13614381.071059 4561814.959402205, -13614390.08820057 4561847.677642196, -13614417.36112945 4561946.115440095, -13614426.4896516 4561978.975033017, -13614434.8386209 4562012.117136017, -13614460.21923892 4562111.82510541, -13614468.67957724 4562145.108578023, -13614458.99500109 4562147.647446834, -13614444.6347413 4562151.455272056, -13614372.83354414 4562170.917398524, -13614348.89983552 4562177.546145472, -13614323.85266311 4562183.469181153, -13614248.60112054 4562201.380113247, -13614223.6655598 4562207.444473356, -13614200.06578664 4562213.649849964, -13614129.37753533 4562232.548513935, -13614105.88945794 4562239.035958929, -13614095.98207233 4562241.71582593, -13614080.06310001 4562245.523405812, -13614002.6963741 4562264.562950457, -13613976.98153368 4562271.050427126, -13613952.82496246 4562277.255635869, -13613880.46728342 4562295.872365994, -13613856.4223189 4562302.218923038, -13613849.40921613 4562274.576241522))"
423500,3501,2924,1769,487,0,500,10,0,158,0,158,577,238,27,11,51,0,96,154,31,123,9354.0,"POLYGON ((-13609672.3680974 4558691.825100407, -13609734.92939879 4558679.418651894, -13609777.23112859 4558672.228171213, -13609904.35751708 4558650.939952223, -13609935.63842684 4558645.864269212, -13609946.77067488 4558644.031583831, -13609982.28122169 4558639.378814898, -13610034.26786399 4558632.752651507, -13610088.92546632 4558625.703725893, -13610124.54752276 4558621.192025749, -13610125.2158262 4558625.844385399, -13610127.21959672 4558639.802039218, -13610127.88733307 4558644.454402438, -13610132.00598348 4558669.831264203, -13610144.36261057 4558745.963356446, -13610148.59294178 4558771.34077148, -13610154.15877544 4558805.882444135, -13610171.19083557 4558909.930496183, -13610176.8679124 4558944.754259552, -13610181.7657637 4558972.810711535, -13610195.79230379 4559052.610450345, -13610196.01482479 4559057.404132497, -13610196.2377676 4559061.492756057, -13610193.34314923 4559074.182111669, -13610191.33929134 4559079.539691123, -13610188.89058226 4559084.333350766, -13610163.39836806 4559088.703990643, -13610087.25582849 4559101.67524009, -13610061.87460096 4559106.186616722, -13610036.04850592 4559110.13457456, -13610027.92229887 4559111.40348905, -13609926.39928338 4559129.167883978, -13609910.36894198 4559131.988076115, -13609892.5579345 4559134.666547252, -13609879.08822202 4559136.781425891, -13609860.27508198 4559140.024265924, -13609763.76137642 4559157.36611391, -13609731.70113398 4559163.287901777, -13609726.35763829 4559164.133899116, -13609710.32769447 4559166.530636369, -13609705.09582912 4559167.517613066, -13609678.04524721 4559172.029047953, -13609597.00439626 4559185.564397181, -13609570.06535192 4559190.217119731, -13609541.23341192 4559194.588162532, -13609454.84968003 4559207.981915871, -13609426.1292944 4559212.634881158, -13609398.18784554 4559217.005802704, -13609314.36450774 4559230.117561024, -13609286.53459319 4559234.629754133, -13609259.70678384 4559238.295017828, -13609249.57653877 4559239.846326424, -13609179.44504999 4559251.971240789, -13609152.72831934 4559256.765362056, -13609156.29061596 4559245.062721962, -13609154.95519208 4559228.989653243, -13609148.38687154 4559143.266908062, -13609146.2722483 4559114.787004802, -13609145.49292303 4559106.609857048, -13609143.15496314 4559082.077308058, -13609142.48726735 4559074.041180422, -13609140.70599485 4559047.393988418, -13609138.03425371 4559006.225068789, -13609135.36282278 4558967.735301335, -13609133.69320646 4558941.229370924, -13609131.57770144 4558914.442019572, -13609125.23239399 4558834.079238469, -13609123.22912004 4558807.433154739, -13609116.66123739 4558731.864594441, -13609100.51991277 4558544.215469276, -13609098.0707399 4558505.304324211, -13609097.18035442 4558490.783238302, -13609092.17104379 4558439.888627787, -13609091.28002206 4558430.020309366, -13609090.94599637 4558426.636609636, -13609090.05552034 4558416.485842304, -13609089.83309522 4558413.102472269, -13609107.53298637 4558403.375041065, -13609147.16250155 4558381.804732625, -13609142.04213176 4558399.286143551, -13609135.58540972 4558422.407301802, -13609136.92120554 4558432.557646586, -13609146.82851442 4558506.995841759, -13609180.89258716 4558761.189587064, -13609181.11480486 4558762.458506064, -13609247.6841221 4558754.986389162, -13609372.13906999 4558737.363285729, -13609491.91900337 4558710.012005409, -13609614.70465354 4558703.526962432, -13609672.3680974 4558691.825100407))"
423601,2804,2603,2011,117,13,275,0,26,161,0,161,201,99,0,0,12,0,65,25,13,12,5284.0,"POLYGON ((-13611274.70082981 4560139.977787763, -13611290.61912191 4560137.43971213, -13611299.97035215 4560136.029440344, -13611376.22414413 4560124.185230337, -13611401.60468581 4560120.378192384, -13611425.98385722 4560116.006822396, -13611499.12081493 4560103.316712424, -13611523.61100282 4560099.08666961, -13611548.6582332 4560095.138281453, -13611623.79866737 4560083.293895439, -13611648.84525108 4560079.345837114, -13611672.22268355 4560075.53912284, -13611742.46495529 4560064.540432901, -13611765.95342475 4560060.874487559, -13611793.22692189 4560056.221702476, -13611875.04691772 4560042.826227305, -13611902.431481 4560038.454818959, -13611923.24789941 4560035.070861813, -13611985.69837552 4560025.341946619, -13612006.62641686 4560022.098802805, -13612036.90530769 4560017.022643728, -13612037.12797755 4560017.022655184, -13612128.07574679 4560002.358392327, -13612158.57730345 4559997.564404065, -13612183.51294916 4559993.475255623, -13612234.27491633 4559985.438065836, -13612258.65371675 4559981.772197561, -13612264.66487271 4559980.925988507, -13612283.81161593 4559978.24726071, -13612287.48553217 4560003.627647299, -13612289.82338843 4560028.866802883, -13612297.94943225 4560116.147610473, -13612303.18164435 4560181.855654236, -13612307.41181831 4560232.899891105, -13612310.63965143 4560283.802802386, -13612312.97775719 4560319.054253075, -13612319.21161349 4560389.558109353, -13612321.99438157 4560436.795292897, -13612322.55103366 4560444.26865768, -13612327.67175546 4560487.558557248, -13612330.00960847 4560516.465366125, -13612331.45672718 4560531.553195172, -13612338.13593446 4560600.084234105, -13612339.80555394 4560628.42742621, -13612342.47710738 4560663.962269518, -13612345.81694427 4560708.239587864, -13612350.15813514 4560766.477986776, -13612352.60719733 4560798.205425687, -13612358.39619057 4560868.712466416, -13612360.06565406 4560890.9927938, -13612362.84846649 4560941.75817355, -13612366.07707029 4561000.279234162, -13612367.41296775 4561025.662299609, -13612369.63917757 4561063.595459854, -13612372.42196574 4561101.811018864, -13612374.42596947 4561127.194342336, -13612359.73157869 4561129.873605266, -13612324.5545571 4561135.514480111, -13612290.71366252 4561141.155275799, -13612217.13145261 4561153.000564817, -13612183.73595366 4561157.513164215, -13612174.83039313 4561158.782545739, -13612124.95902483 4561166.538381005, -13612097.79718422 4561171.05096927, -13612016.42263916 4561184.729876432, -13611989.37182432 4561189.383175202, -13611966.10596119 4561193.331989703, -13611896.30889879 4561205.318258245, -13611873.15408267 4561209.407858905, -13611822.94916955 4561217.445653106, -13611672.55666251 4561241.559911994, -13611622.46255117 4561249.739462582, -13611591.96097656 4561254.252166108, -13611572.92577289 4561257.354037089, -13611424.87095816 4561282.173935174, -13611375.55628528 4561290.634664192, -13611373.32996234 4561264.264131299, -13611366.65062498 4561185.575590414, -13611364.42438677 4561159.346589663, -13611362.30910763 4561134.527212872, -13611358.63580385 4561089.119619376, -13611355.74128539 4561060.352519557, -13611353.29233689 4561035.674320128, -13611350.95457453 4561009.586657754, -13611343.94154222 4560931.886837204, -13611341.71492791 4560905.940422562, -13611336.92817057 4560854.61080884, -13611322.56823835 4560700.907132264, -13611317.78112956 4560649.719771218, -13611313.8850148 4560599.237935605, -13611302.30797737 4560447.934862207, -13611298.52309469 4560397.595548159, -13611296.40788259 4560372.072804722, -13611290.17400415 4560295.788334953, -13611288.17049229 4560270.407397453, -13611286.2776768 4560252.922370254, -13611285.3871257 4560244.320990363, -13611282.04765753 4560211.88973613, -13611277.37252625 4560166.063636261, -13611274.70082981 4560139.977787763))"
423602,6222,5608,2518,346,93,2226,36,9,380,0,380,614,298,0,8,0,0,210,98,76,22,16977.0,"POLYGON ((-13610767.97442789 4558510.661608182, -13610785.45177104 4558510.661460525, -13610805.48916201 4558510.661427168, -13610826.6399902 4558505.304364631, -13610890.31445693 4558489.373625998, -13610911.57627851 4558484.156791694, -13610909.12755943 4558468.93117888, -13610901.78039286 4558423.5352121, -13610899.44277818 4558408.450076026, -13610896.43688929 4558389.981558611, -13610887.53153155 4558334.858399362, -13610884.63732403 4558316.530974307, -13610883.18992849 4558304.266182848, -13610879.18261627 4558267.611183927, -13610877.95790672 4558255.487144106, -13610874.61846059 4558230.957076952, -13610864.59976241 4558157.78975456, -13610862.37335097 4558140.872173255, -13610861.37144961 4558133.400299288, -13610856.69587572 4558076.304806731, -13610928.27456993 4558070.10192858, -13610999.85297748 4558061.220366454, -13610990.50211707 4557986.503801188, -13610937.73638927 4557864.561342728, -13610941.41003287 4557824.665774284, -13610963.22853092 4557819.731407103, -13611122.41553704 4557784.48838904, -13611147.5735911 4557778.990927698, -13611150.35705275 4557778.426695569, -13611175.51503708 4557772.787944444, -13611180.30169753 4557783.924435515, -13611187.09223918 4557792.241854385, -13611187.64868215 4557792.805967021, -13611219.04119623 4557823.678814962, -13611230.50662696 4557840.313679918, -13611232.28770718 4557844.260780572, -13611233.95767106 4557847.926276832, -13611240.85947538 4557867.66269527, -13611240.3027686 4557869.917945817, -13611239.07832455 4557876.261797724, -13611238.52180526 4557890.077557569, -13611238.52176728 4557891.768837678, -13611235.51630275 4557918.131140979, -13611231.84294591 4557944.493424646, -13611229.39350438 4557957.321870582, -13611226.38821249 4557973.393055534, -13611225.72003004 4557979.736750662, -13611223.15989064 4558002.856814273, -13611217.59384761 4558036.550042071, -13611210.9149003 4558061.925631543, -13611207.12993904 4558075.740928193, -13611204.56971825 4558084.058495319, -13611181.19261017 4558158.494553455, -13611164.38283961 4558215.308753051, -13611129.42864949 4558328.937241829, -13611124.75328939 4558351.494256075, -13611123.63989365 4558369.680464245, -13611123.52887089 4558377.293562847, -13611123.41729032 4558392.519499319, -13611125.08755281 4558406.47632882, -13611130.43079616 4558444.259484493, -13611131.20995222 4558454.409812338, -13611133.54772796 4558480.209288491, -13611134.99483437 4558505.586145869, -13611139.55896076 4558582.139677786, -13611141.11717066 4558607.657743359, -13611144.56821597 4558657.988786846, -13611149.57732406 4558727.494202546, -13611155.5889886 4558790.514416988, -13611157.59268964 4558808.983713515, -13611163.38131237 4558859.175075146, -13611158.70566645 4558860.725785534, -13611152.24921173 4558861.571776321, -13611138.000157 4558864.250518355, -13611061.85800074 4558878.631350946, -13611036.47727756 4558883.56589001, -13611006.42048671 4558902.599016343, -13611003.0809968 4558905.278065206, -13610998.51715611 4558909.648660813, -13610947.30997228 4558906.687391517, -13610937.29113284 4558913.59627807, -13610919.3686281 4558924.593291512, -13610909.68399554 4558933.475287091, -13610906.90084682 4558936.294781129, -13610878.73728673 4558960.403721328, -13610868.60707948 4558966.466545335, -13610851.13032473 4558971.401097361, -13610788.34568705 4558980.847397921, -13610745.48799956 4558987.332779742, -13610727.45433637 4558990.434620932, -13610673.35275416 4558999.880625348, -13610655.43012486 4559003.123317347, -13610644.07568391 4559010.031738597, -13610632.16477922 4559012.006051422, -13610559.36185699 4559024.553579909, -13610535.09422042 4559028.924490861, -13610513.94330849 4559031.885263218, -13610450.82536446 4559040.908355362, -13610429.78604424 4559044.010510841, -13610406.18622763 4559048.240021923, -13610335.72098233 4559061.211084384, -13610312.23215832 4559065.581936496, -13610287.51944732 4559069.247123313, -13610213.49172549 4559080.526839746, -13610188.89058226 4559084.333350766, -13610191.33929134 4559079.539691123, -13610193.34314923 4559074.182111669, -13610196.2377676 4559061.492756057, -13610196.01482479 4559057.404132497, -13610195.79230379 4559052.610450345, -13610181.7657637 4558972.810711535, -13610176.8679124 4558944.754259552, -13610171.19083557 4558909.930496183, -13610154.15877544 4558805.882444135, -13610148.59294178 4558771.34077148, -13610144.36261057 4558745.963356446, -13610132.00598348 4558669.831264203, -13610127.88733307 4558644.454402438, -13610127.21959672 4558639.802039218, -13610125.2158262 4558625.844385399, -13610124.54752276 4558621.192025749, -13610220.1710515 4558604.979068354, -13610507.37533369 4558556.621857119, -13610596.20839639 4558541.677859882, -13610603.1105054 4558540.691093122, -13610623.59287569 4558534.769363092, -13610685.04154471 4558517.005676708, -13610705.63545984 4558511.225339082, -13610725.56177864 4558511.084494282, -13610767.97442789 4558510.661608182))"
423700,4399,4039,2784,89,5,875,20,6,260,6,254,360,251,0,27,13,0,63,6,6,0,10899.0,"POLYGON ((-13612025.99614691 4558591.72683288, -13612023.76943128 4558580.589141525, -13612021.20914966 4558566.772841672, -13612007.40584951 4558492.192858571, -13612002.84162852 4558467.380341785, -13612001.06029228 4558456.383463494, -13611995.71702684 4558423.817172757, -13611994.04736186 4558412.961294628, -13611991.37566214 4558399.427380805, -13611983.47164239 4558358.824886382, -13611980.91162538 4558345.431994694, -13611979.68727316 4558339.087637376, -13611976.34736693 4558320.19668918, -13611975.34570572 4558313.993590966, -13611971.56058125 4558293.692635434, -13611960.20591881 4558232.930660227, -13611958.75888185 4558224.895020541, -13611956.30987416 4558212.77079694, -13611951.74610406 4558188.522697377, -13611938.16491766 4558116.060320049, -13611935.60479985 4558102.103954245, -13611933.48968379 4558091.953370771, -13611928.48026199 4558064.886090097, -13611913.45168908 4557983.965960463, -13611910.00108892 4557965.357223751, -13611908.33139265 4557957.039885875, -13611900.9842067 4557919.258741086, -13612099.80057257 4557906.571465604, -13612137.98354403 4557895.71607791, -13612252.75357556 4557863.433295429, -13612291.04788306 4557852.719472317, -13612310.08333194 4557845.106616229, -13612347.4865674 4557830.586358363, -13612355.27904768 4557855.256917209, -13612362.84846844 4557878.799429558, -13612365.7429594 4557887.821929911, -13612372.08831977 4557907.41730278, -13612399.91806901 4557993.270476626, -13612409.26915096 4558021.888343956, -13612413.49888612 4558032.179731188, -13612426.52357145 4558063.194329463, -13612430.86499921 4558073.626696907, -13612438.32306706 4558120.994733972, -13612441.77415657 4558142.423019688, -13612536.84092858 4558114.509929327, -13612542.29552731 4558112.958987684, -13612542.18438326 4558154.406347415, -13612548.41848443 4558181.473856933, -13612567.23137262 4558262.536402454, -13612573.57669411 4558289.745120078, -13612581.36873993 4558303.70185196, -13612604.7461963 4558345.713938132, -13612612.64942034 4558359.811665831, -13612655.61894089 4558341.766761437, -13612784.86111923 4558288.194644587, -13612814.47198136 4558276.07033781, -13612828.3867636 4558272.263876645, -13612831.17000497 4558283.401342848, -13612839.85249303 4558317.236055099, -13612842.74692432 4558328.655167904, -13612846.08671582 4558341.484313692, -13612856.43936709 4558380.254002853, -13612859.89029031 4558393.224149393, -13612863.11854153 4558407.322465518, -13612866.34673725 4558421.279565996, -13612870.24273226 4558442.285752038, -13612872.24660886 4558449.89857565, -13612876.03170852 4558463.855428825, -13612877.92385523 4558471.186657398, -13612883.82415586 4558493.321036276, -13612885.82798748 4558500.792659718, -13612889.05570927 4558513.622285776, -13612899.07487875 4558552.110398747, -13612899.1860445 4558552.392577731, -13612903.63883828 4558564.516907622, -13612888.0538813 4558562.824891889, -13612837.96023994 4558575.37231451, -13612835.39986374 4558575.93646815, -13612631.90792979 4558627.959346564, -13612615.98902524 4558632.188815352, -13612595.17277029 4558636.841424931, -13612564.33711008 4558646.710022656, -13612512.9074648 4558659.398919808, -13612482.96239142 4558667.012090526, -13612358.61863717 4558696.759697845, -13612307.18895524 4558709.166299813, -13612301.62314957 4558711.140055069, -13612294.94412094 4558711.70369703, -13612294.49883677 4558711.703685927, -13612256.09307373 4558712.408555384, -13612243.29160704 4558712.831609125, -13612235.72183121 4558712.97261744, -13612213.12405137 4558713.254663453, -13612205.66536867 4558713.536602789, -13612194.31078616 4558713.959928071, -13612160.13606304 4558715.369635211, -13612148.89257452 4558715.933292511, -13612141.65710028 4558716.21519884, -13612120.28378258 4558717.061180718, -13612113.15939938 4558717.484021174, -13612100.35740712 4558718.048131245, -13612082.54635829 4558718.89419038, -13612069.41050269 4558720.444906179, -13612062.17496642 4558720.586091247, -13612049.48446623 4558720.867956804, -13612044.80914708 4558694.927021842, -13612032.34115946 4558625.703462879, -13612030.78287342 4558617.385342224, -13612025.99614691 4558591.72683288))"
423800,3016,2788,2317,28,0,288,0,7,148,0,148,228,218,0,0,0,0,0,10,10,0,8775.0,"POLYGON ((-13613303.83211285 4560154.783079713, -13613305.39091133 4560160.564191673, -13613311.73610155 4560182.701854656, -13613318.74922051 4560210.197561204, -13613339.7883604 4560292.968171402, -13613346.91331509 4560320.605687933, -13613359.82594774 4560369.957845477, -13613371.62569096 4560414.516048348, -13613377.30343146 4560438.346526287, -13613397.67483741 4560518.862694102, -13613410.36491041 4560568.63895372, -13613416.82171998 4560593.174576549, -13613424.0575639 4560620.812532187, -13613437.1929038 4560666.641266347, -13613444.31731885 4560691.177042267, -13613448.21390921 4560707.393735182, -13613460.23636297 4560756.043058866, -13613464.24356824 4560772.400237805, -13613466.35903383 4560781.565968944, -13613473.03805717 4560809.063454203, -13613475.26459431 4560818.229489812, -13613481.83233983 4560843.04788838, -13613501.64739138 4560917.50311901, -13613508.3263175 4560942.322010394, -13613500.97908504 4560944.155146189, -13613491.62862987 4560945.706498956, -13613449.10449409 4560952.193073755, -13613389.32582804 4560961.500210078, -13613285.46452771 4560979.691156344, -13613271.54992226 4560981.665005207, -13613212.32759291 4560990.267338416, -13613178.4864965 4560995.908104054, -13613124.94199183 4561004.93313023, -13613077.29715759 4561013.675915006, -13613043.6788774 4561019.880741948, -13613031.767827 4561021.854752512, -13612996.2567676 4561027.777262427, -13612984.45682399 4561029.892767751, -13612963.63982093 4561033.136183424, -13612901.41270063 4561043.148151763, -13612880.70677458 4561046.532381284, -13612835.17732598 4561053.865625421, -13612829.83418029 4561054.570392478, -13612775.84394198 4561062.890755525, -13612729.75759459 4561072.056902992, -13612677.66049397 4561080.658421176, -13612627.00988912 4561089.119830658, -13612576.47097764 4561096.593547792, -13612536.17299339 4561102.657220115, -13612450.67957542 4561115.349133001, -13612424.85392915 4561119.297499428, -13612374.42596947 4561127.194342336, -13612372.42196574 4561101.811018864, -13612369.63917757 4561063.595459854, -13612367.41296775 4561025.662299609, -13612366.07707029 4561000.279234162, -13612362.84846649 4560941.75817355, -13612360.06565406 4560890.9927938, -13612358.39619057 4560868.712466416, -13612352.60719733 4560798.205425687, -13612350.15813514 4560766.477986776, -13612345.81694427 4560708.239587864, -13612342.47710738 4560663.962269518, -13612339.80555394 4560628.42742621, -13612338.13593446 4560600.084234105, -13612331.45672718 4560531.553195172, -13612330.00960847 4560516.465366125, -13612327.67175546 4560487.558557248, -13612322.55103366 4560444.26865768, -13612321.99438157 4560436.795292897, -13612319.21161349 4560389.558109353, -13612312.97775719 4560319.054253075, -13612310.63965143 4560283.802802386, -13612307.41181831 4560232.899891105, -13612303.18164435 4560181.855654236, -13612297.94943225 4560116.147610473, -13612289.82338843 4560028.866802883, -13612287.48553217 4560003.627647299, -13612283.81161593 4559978.24726071, -13612303.96075472 4559974.439924784, -13612350.15850492 4559965.979734224, -13612364.62978211 4559963.442018905, -13612384.89014987 4559960.198689053, -13612406.37471507 4559956.533004547, -13612471.16273855 4559945.816773672, -13612492.75835639 4559942.291880963, -13612496.0980212 4559941.445524623, -13612506.2282952 4559939.471749688, -13612509.67912753 4559938.90760961, -13612522.03551011 4559936.933827602, -13612559.32749095 4559931.434441125, -13612571.79553676 4559929.601571064, -13612590.2746148 4559926.781609684, -13612595.06144722 4559926.217438751, -13612646.04569744 4559918.744429917, -13612664.63585024 4559916.065302853, -13612683.89412044 4559912.399651861, -13612741.66911818 4559901.965217031, -13612743.45033048 4559901.683251821, -13612760.92733705 4559898.299426902, -13612768.94228185 4559897.171529703, -13612793.32146153 4559893.928191978, -13612801.44751383 4559892.941232821, -13612824.15669033 4559889.134279542, -13612892.61803893 4559878.136016806, -13612915.43883291 4559874.470405471, -13612925.56903651 4559872.636912004, -13612955.9587433 4559867.701949101, -13612966.20011047 4559866.151202505, -13612978.55682708 4559864.036209978, -13613015.62644427 4559857.832394608, -13613028.09425848 4559855.858304336, -13613047.90888516 4559852.614867668, -13613107.4650047 4559843.168270897, -13613127.39126752 4559840.066220321, -13613146.2040479 4559836.682260987, -13613202.86576317 4559826.95335986, -13613206.76185571 4559826.388965008, -13613213.44070044 4559825.261384267, -13613221.67878791 4559823.004833055, -13613233.59003859 4559866.29216555, -13613234.81454248 4559872.21411518, -13613244.72174596 4559916.347570309, -13613270.88155827 4560021.393841381, -13613283.34941691 4560071.026660472, -13613288.80445971 4560093.305469702, -13613303.83211285 4560154.783079713))"
423901,1954,1718,1218,214,7,215,0,17,47,0,47,236,108,10,0,0,0,40,78,43,35,4040.0,"POLYGON ((-13608255.71639831 4560685.396104825, -13608245.91998987 4560631.952340367, -13608236.12366158 4560578.086769736, -13608236.9030258 4560563.703855782, -13608239.2411152 4560520.836609643, -13608240.13152799 4560506.594792828, -13608263.9537818 4560508.851160942, -13608335.75493176 4560516.042432325, -13608359.68829068 4560518.439600991, -13608363.02799552 4560520.554725304, -13608373.15817564 4560526.899851412, -13608376.60893879 4560529.015301961, -13608413.12180097 4560531.553261485, -13608469.56096459 4560535.783547375, -13608475.68324634 4560535.501440406, -13608522.99445454 4560532.117453001, -13608559.61815738 4560529.578970176, -13608631.86489808 4560525.067148643, -13608646.44730177 4560524.502767414, -13608761.99724559 4560514.914359331, -13608861.51694112 4560506.171659122, -13608879.21680243 4560505.325547088, -13608929.19888715 4560503.210285842, -13608932.31581248 4560502.928285797, -13608950.12723462 4560501.518480203, -13608958.3645953 4560500.53138027, -13608983.41159278 4560498.134349934, -13608991.76060158 4560497.42892845, -13609017.47562263 4560495.032047519, -13609094.61952785 4560488.263652856, -13609120.44614551 4560486.007531984, -13609145.82685649 4560484.033144275, -13609222.41485488 4560478.110901685, -13609247.90659773 4560476.277844855, -13609250.57827438 4560501.095392692, -13609253.47267692 4560526.195020715, -13609264.15912358 4560574.279373473, -13609269.61403298 4560598.533273908, -13609274.06671459 4560623.633051306, -13609277.85144325 4560644.643489175, -13609281.74790372 4560675.806933422, -13609283.41785731 4560700.20226702, -13609285.31010671 4560726.007503355, -13609288.87205253 4560750.402118465, -13609299.55916135 4560824.011245863, -13609303.23281223 4560848.547673283, -13609306.23809076 4560875.058232788, -13609315.36626487 4560955.013293333, -13609318.48324878 4560981.665137244, -13609315.14353499 4560982.229157288, -13609305.01389865 4560983.92146863, -13609301.78524131 4560984.485803389, -13609254.80876122 4560992.241165537, -13609113.87832608 4561015.508855748, -13609066.90099442 4561023.265094911, -13609067.01254988 4561011.13755748, -13609067.45768508 4560974.614650566, -13609067.68031289 4560962.628185858, -13609049.98043785 4560965.307692601, -13609037.29011775 4560966.858457256, -13608946.11986465 4560978.562737083, -13608915.84062156 4560982.652284188, -13608898.92018807 4560983.075254759, -13608848.38102001 4560984.626610866, -13608831.57165333 4560985.190490564, -13608825.44912779 4560985.613512252, -13608807.30424674 4560987.023904237, -13608801.29279022 4560987.587931425, -13608770.6801192 4561005.214879835, -13608770.34611251 4561009.58633068, -13608762.55394551 4561118.169060601, -13608760.88414853 4561119.861673907, -13608746.85761416 4561123.951022083, -13608738.28593888 4561124.232967113, -13608720.58652572 4561122.117953409, -13608690.0845071 4561114.925871818, -13608681.06775263 4561110.977541629, -13608665.59462988 4561097.862602664, -13608659.36071198 4561094.055146084, -13608652.7925859 4561092.080906191, -13608644.44350565 4561090.389098423, -13608634.75890464 4561089.683944274, -13608626.1872726 4561090.247761395, -13608619.73098557 4561091.7992593, -13608588.00466266 4561106.747020324, -13608567.29934754 4561117.464045205, -13608542.25227934 4561127.335452609, -13608524.10727504 4561131.988836682, -13608516.31486106 4561135.091425945, -13608511.86226485 4561137.911638306, -13608488.81913985 4561156.103178993, -13608484.58873753 4561160.897812026, -13608446.96288955 4561140.732274128, -13608334.30778986 4561080.658398966, -13608296.79301764 4561060.634069521, -13608294.56658481 4561057.532112733, -13608288.22163443 4561048.506920621, -13608286.10627577 4561045.545419778, -13608285.99499139 4561036.661218813, -13608285.99489594 4561010.432314152, -13608285.99524053 4561001.689744811, -13608280.54056071 4560971.230095647, -13608264.51044463 4560879.852657457, -13608259.27857441 4560849.534709829, -13608265.28983477 4560794.539351164, -13608269.2973366 4560759.144835706, -13608255.71639831 4560685.396104825))"
423902,1593,1505,1173,42,0,204,0,18,68,6,62,88,47,9,0,0,0,17,15,0,15,3104.0,"POLYGON ((-13608484.58873753 4561160.897812026, -13608488.81913985 4561156.103178993, -13608511.86226485 4561137.911638306, -13608516.31486106 4561135.091425945, -13608524.10727504 4561131.988836682, -13608542.25227934 4561127.335452609, -13608567.29934754 4561117.464045205, -13608588.00466266 4561106.747020324, -13608619.73098557 4561091.7992593, -13608626.1872726 4561090.247761395, -13608634.75890464 4561089.683944274, -13608644.44350565 4561090.389098423, -13608652.7925859 4561092.080906191, -13608659.36071198 4561094.055146084, -13608665.59462988 4561097.862602664, -13608681.06775263 4561110.977541629, -13608690.0845071 4561114.925871818, -13608720.58652572 4561122.117953409, -13608738.28593888 4561124.232967113, -13608746.85761416 4561123.951022083, -13608760.88414853 4561119.861673907, -13608762.55394551 4561118.169060601, -13608770.34611251 4561009.58633068, -13608770.6801192 4561005.214879835, -13608801.29279022 4560987.587931425, -13608807.30424674 4560987.023904237, -13608825.44912779 4560985.613512252, -13608831.57165333 4560985.190490564, -13608848.38102001 4560984.626610866, -13608898.92018807 4560983.075254759, -13608915.84062156 4560982.652284188, -13608946.11986465 4560978.562737083, -13609037.29011775 4560966.858457256, -13609049.98043785 4560965.307692601, -13609067.68031289 4560962.628185858, -13609067.45768508 4560974.614650566, -13609067.01254988 4561011.13755748, -13609066.90099442 4561023.265094911, -13609113.87832608 4561015.508855748, -13609254.80876122 4560992.241165537, -13609301.78524131 4560984.485803389, -13609305.01389865 4560983.92146863, -13609315.14353499 4560982.229157288, -13609318.48324878 4560981.665137244, -13609370.91454468 4560972.781327844, -13609528.32075656 4560946.693741234, -13609580.86337673 4560938.091747427, -13609609.69497972 4560933.579197774, -13609613.03466323 4560933.015084832, -13609709.54892838 4560917.926352066, -13609741.83117365 4560912.990878151, -13609759.7539252 4560909.606789738, -13609813.52107603 4560900.017684575, -13609831.55489466 4560896.915177704, -13609882.42783828 4560889.018438393, -13610027.14303615 4560866.597068629, -13610035.04678673 4560865.327897299, -13610085.91996963 4560857.290059458, -13610136.12498041 4560849.111696807, -13610199.35418331 4560839.09934172, -13610287.07396652 4560824.998193828, -13610337.39033173 4560816.960453716, -13610387.37322133 4560807.935554834, -13610537.65462136 4560781.142895789, -13610574.27834318 4560774.6566837, -13610587.7481924 4560771.977239693, -13610588.63863205 4560786.924580478, -13610590.30857967 4560796.513463377, -13610590.53118219 4560798.48778238, -13610592.98001477 4560818.652544044, -13610596.87624937 4560832.753789281, -13610600.88384356 4560845.726950838, -13610612.79474527 4560871.955722697, -13610613.12877243 4560873.083911583, -13610618.47241819 4560887.890397208, -13610620.58742777 4560898.325331069, -13610619.91966777 4560913.273130361, -13610619.91958947 4560915.247428539, -13610618.36078312 4560922.156609854, -13610614.13088178 4560936.117193487, -13610605.89296299 4560954.026216089, -13610600.10456195 4560967.140653726, -13610594.20451419 4560980.255366591, -13610589.8630268 4560989.985118039, -13610580.06693014 4561008.599110955, -13610577.95199441 4561014.663211129, -13610576.72751766 4561019.457217664, -13610573.27679073 4561033.982276667, -13610574.27863644 4561045.686276976, -13610577.61803499 4561081.222510932, -13610578.73098122 4561093.068137888, -13610580.17866937 4561106.605930919, -13610584.6311152 4561147.21856153, -13610586.1899147 4561160.897426938, -13610587.52573597 4561180.35803919, -13610591.86709035 4561239.163108751, -13610593.42566355 4561258.764607616, -13610593.75953671 4561263.840993518, -13610594.87284972 4561279.353590645, -13610595.31782262 4561284.570991348, -13610597.54435563 4561310.51849069, -13610604.22340476 4561388.221236943, -13610606.56107873 4561414.309997127, -13610607.89681389 4561428.553110923, -13610609.23280769 4561441.527071833, -13610618.24941097 4561523.319888494, -13610621.25556807 4561550.678298063, -13610623.14788136 4561574.370268444, -13610628.82486864 4561645.446498333, -13610629.7156152 4561656.587479347, -13610625.48535611 4561668.010635089, -13610604.33480261 4561670.972310074, -13610541.2163471 4561680.138835113, -13610520.17745464 4561683.382061263, -13610487.33786517 4561688.45947242, -13610451.71544928 4561694.241168837, -13610444.0348638 4561695.087546569, -13610438.80243149 4561696.356530754, -13610410.63891685 4561708.484795852, -13610396.16738363 4561715.113215554, -13610391.38044139 4561716.805532863, -13610373.01298407 4561723.574670433, -13610359.54327398 4561727.523279854, -13610321.13801842 4561734.856575804, -13610319.35699746 4561735.138744566, -13610198.57521763 4561755.728311647, -13610158.38860224 4561762.779772142, -13610114.52925997 4561769.831075001, -13609989.51738403 4561789.716017871, -13609983.1718567 4561790.843799551, -13609939.42337336 4561798.036537849, -13609899.12580116 4561804.382602334, -13609778.23281499 4561823.562295613, -13609738.04671169 4561830.049342777, -13609704.65033411 4561834.844197895, -13609604.46329462 4561849.229289094, -13609589.88047621 4561851.485850802, -13609571.1785629 4561854.86999994, -13609545.90885404 4561859.242011517, -13609470.32286596 4561872.216477494, -13609445.1647345 4561876.729278415, -13609436.81576849 4561877.293873716, -13609435.14628732 4561877.152377328, -13609420.78574585 4561876.729611613, -13609405.42394088 4561872.498562309, -13609395.62781966 4561869.959972493, -13609333.51143639 4561870.94742168, -13609346.31315189 4561944.986846151, -13609400.41437693 4562255.395611472, -13609371.36008276 4562262.729740934, -13609395.62760828 4562366.671053381, -13609430.35919837 4562515.040308584, -13609286.86847774 4562537.606113752, -13608969.49657888 4562587.674175508, -13608860.51513219 4562628.152151891, -13608848.38120821 4562632.524614701, -13608721.9223855 4562679.913336839, -13608705.89190696 4562663.975913215, -13608661.14185053 4562658.19309641, -13608503.84745752 4562638.306978486, -13608466.10981085 4562633.51196277, -13608401.2104229 4562625.331541951, -13608398.76191148 4562551.427945342, -13608395.42212191 4562515.604642514, -13608383.84507177 4562393.749949733, -13608381.95214873 4562373.722885654, -13608339.42850137 4562015.783594998, -13608336.31146623 4561989.129419041, -13608326.29276014 4561883.780755858, -13608320.1701958 4561819.895307744, -13608319.39077555 4561811.715996573, -13608307.03415623 4561702.42067195, -13608281.09679007 4561472.129175673, -13608279.76138836 4561410.925227798, -13608278.64796611 4561390.477382884, -13608275.30823407 4561326.453929087, -13608282.321306 4561145.808614937, -13608285.54973286 4561064.300971238, -13608285.66126883 4561060.493352819, -13608285.8836757 4561049.212006704, -13608286.10627577 4561045.545419778, -13608288.22163443 4561048.506920621, -13608294.56658481 4561057.532112733, -13608296.79301764 4561060.634069521, -13608334.30778986 4561080.658398966, -13608446.96288955 4561140.732274128, -13608484.58873753 4561160.897812026))"
424001,4151,3532,1989,908,33,366,14,46,176,65,111,619,114,19,0,9,0,436,41,23,18,14864.0,"POLYGON ((-13610789.34745052 4561384.55441169, -13610768.97633258 4561388.36211718, -13610756.61968781 4561390.618326448, -13610726.6747386 4561396.541075688, -13610707.9732827 4561399.361479781, -13610687.60192473 4561402.46437894, -13610671.34886015 4561404.72063728, -13610622.7024681 4561411.771554666, -13610606.56107873 4561414.309997127, -13610604.22340476 4561388.221236943, -13610597.54435563 4561310.51849069, -13610595.31782262 4561284.570991348, -13610594.87284972 4561279.353590645, -13610593.75953671 4561263.840993518, -13610593.42566355 4561258.764607616, -13610591.86709035 4561239.163108751, -13610587.52573597 4561180.35803919, -13610586.1899147 4561160.897426938, -13610584.6311152 4561147.21856153, -13610580.17866937 4561106.605930919, -13610578.73098122 4561093.068137888, -13610577.61803499 4561081.222510932, -13610574.27863644 4561045.686276976, -13610573.27679073 4561033.982276667, -13610576.72751766 4561019.457217664, -13610577.95199441 4561014.663211129, -13610580.06693014 4561008.599110955, -13610589.8630268 4560989.985118039, -13610594.20451419 4560980.255366591, -13610600.10456195 4560967.140653726, -13610605.89296299 4560954.026216089, -13610614.13088178 4560936.117193487, -13610618.36078312 4560922.156609854, -13610619.91958947 4560915.247428539, -13610619.91966777 4560913.273130361, -13610620.58742777 4560898.325331069, -13610618.47241819 4560887.890397208, -13610613.12877243 4560873.083911583, -13610612.79474527 4560871.955722697, -13610600.88384356 4560845.726950838, -13610596.87624937 4560832.753789281, -13610592.98001477 4560818.652544044, -13610590.53118219 4560798.48778238, -13610590.30857967 4560796.513463377, -13610588.63863205 4560786.924580478, -13610587.7481924 4560771.977239693, -13610584.5197613 4560747.440944006, -13610581.29177447 4560722.340796455, -13610578.84277537 4560701.330349704, -13610576.28224714 4560673.69170023, -13610575.39179997 4560663.256930167, -13610571.04996075 4560650.142940811, -13610566.93112777 4560624.338250502, -13610554.68638255 4560546.92314538, -13610550.67871746 4560521.259697803, -13610546.44835937 4560495.455006777, -13610533.86970202 4560418.46425572, -13610529.75051223 4560392.800804537, -13610525.85472074 4560367.701928716, -13610520.95663443 4560335.552270242, -13610518.28494236 4560318.349081088, -13610514.72279811 4560292.686267828, -13610514.61140652 4560291.276237858, -13610508.37735705 4560268.714910004, -13610556.91281436 4560260.395932878, -13610579.39920487 4560256.588590886, -13610666.56216374 4560241.92412889, -13610700.96005444 4560235.578644681, -13610702.74137441 4560235.297023298, -13610736.24824951 4560230.079604534, -13610751.38769249 4560227.400660761, -13610804.26459523 4560218.940340295, -13610819.96048426 4560216.5430484, -13610962.78354778 4560192.854064464, -13611015.66002701 4560184.111888531, -13611067.423538 4560175.087921158, -13611222.82578287 4560148.156068377, -13611265.57266207 4560140.82361576, -13611274.70082981 4560139.977787763, -13611277.37252625 4560166.063636261, -13611282.04765753 4560211.88973613, -13611285.3871257 4560244.320990363, -13611286.2776768 4560252.922370254, -13611288.17049229 4560270.407397453, -13611290.17400415 4560295.788334953, -13611296.40788259 4560372.072804722, -13611298.52309469 4560397.595548159, -13611302.30797737 4560447.934862207, -13611313.8850148 4560599.237935605, -13611317.78112956 4560649.719771218, -13611322.56823835 4560700.907132264, -13611336.92817057 4560854.61080884, -13611341.71492791 4560905.940422562, -13611343.94154222 4560931.886837204, -13611350.95457453 4561009.586657754, -13611353.29233689 4561035.674320128, -13611355.74128539 4561060.352519557, -13611358.63580385 4561089.119619376, -13611362.30910763 4561134.527212872, -13611364.42438677 4561159.346589663, -13611366.65062498 4561185.575590414, -13611373.32996234 4561264.264131299, -13611375.55628528 4561290.634664192, -13611365.64875444 4561292.186077218, -13611355.40746237 4561293.737157501, -13611295.29490348 4561303.749948394, -13611275.25718777 4561307.133986823, -13611243.1972043 4561312.351850229, -13611243.08618417 4561312.492824227, -13611158.48335844 4561327.723023565, -13611147.57394617 4561329.415654573, -13611115.62494146 4561334.774131699, -13611063.75004376 4561342.812384847, -13610908.12540988 4561366.786061526, -13610856.36187434 4561374.964874236, -13610842.89222248 4561376.798327252, -13610802.70601855 4561382.580023256, -13610789.34745052 4561384.55441169))"
424002,2507,1919,732,762,15,265,0,4,141,0,141,588,153,18,10,6,0,287,114,26,88,4344.0,"POLYGON ((-13611290.61912191 4560137.43971213, -13611274.70082981 4560139.977787763, -13611272.47405518 4560114.314679393, -13611265.79505283 4560037.750073735, -13611263.67997802 4560012.228770256, -13611261.11970966 4559987.130091539, -13611253.77281376 4559912.258497978, -13611251.32368351 4559887.301034936, -13611249.31958606 4559861.357205865, -13611243.30849629 4559783.524966128, -13611241.30500483 4559757.581396333, -13611239.07868305 4559732.906828522, -13611232.39934532 4559659.305500143, -13611230.28415249 4559634.772137251, -13611228.39206993 4559609.815688337, -13611222.9369566 4559535.369312075, -13611221.15599506 4559510.554072286, -13611218.48449855 4559484.187914755, -13611210.58068555 4559405.51329705, -13611208.02032618 4559379.288373286, -13611205.7938539 4559353.627109851, -13611199.44892632 4559277.209004356, -13611197.33357467 4559251.689531362, -13611194.88449467 4559226.029119907, -13611187.76001881 4559149.188959208, -13611185.42263651 4559123.669769899, -13611180.63573597 4559070.798556568, -13611175.29214747 4559011.019017871, -13611169.61486779 4558919.235778724, -13611168.83593938 4558911.904080517, -13611163.38131237 4558859.175075146, -13611185.86792143 4558855.509289541, -13611253.32721441 4558844.935358685, -13611253.54981695 4558844.794147625, -13611276.259193 4558843.525254175, -13611291.8438925 4558843.948592814, -13611299.97026782 4558842.53862239, -13611370.76919517 4558830.695482269, -13611394.48045336 4558826.889012591, -13611417.52371353 4558822.941749395, -13611473.18342298 4558813.636262188, -13611486.87561698 4558811.521678587, -13611510.14164593 4558808.13804782, -13611569.92010022 4558797.987038488, -13611709.95994859 4558774.724279586, -13611749.70118837 4558769.085074888, -13611809.81349412 4558760.625590175, -13611851.66944665 4558753.435681529, -13611977.46086026 4558732.146889688, -13612019.42825202 4558725.097279141, -13612025.32812168 4558723.969684501, -13612031.56172803 4558722.982481104, -13612038.35249383 4558722.700633954, -13612043.47293995 4558721.854605603, -13612049.48446623 4558720.867956804, -13612053.93724031 4558745.540093932, -13612062.28633962 4558791.501373015, -13612067.18418175 4558819.839598609, -13612071.63709018 4558844.653200395, -13612075.53333716 4558865.6605253, -13612083.54806887 4558907.95663934, -13612087.11022053 4558929.245692376, -13612090.67238617 4558950.534787432, -13612095.23676703 4558981.9752785, -13612109.04014081 4559076.719596525, -13612113.71572387 4559108.301417287, -13612118.16834188 4559133.25692083, -13612127.85323221 4559187.538387619, -13612130.97019899 4559208.687302659, -13612134.86666439 4559233.924648415, -13612139.09684155 4559259.16235075, -13612151.78703899 4559335.157155617, -13612156.0173537 4559360.535769171, -13612160.24717308 4559386.055684511, -13612173.04893167 4559462.616089782, -13612177.3904472 4559488.135967217, -13612181.28689385 4559512.810119378, -13612193.19791657 4559586.974163932, -13612197.20553745 4559611.789508173, -13612201.21260723 4559636.604905217, -13612213.45772439 4559711.052027843, -13612217.57705631 4559735.867378102, -13612219.35785328 4559754.338701453, -13612220.47118022 4559761.388137839, -13612225.14652202 4559788.037312763, -13612229.26544815 4559807.4949926, -13612237.28031266 4559835.695297382, -13612238.61592077 4559840.348078703, -13612246.5198224 4559858.818914235, -13612255.64826168 4559881.802177642, -13612268.56094009 4559914.514319553, -13612279.91556188 4559952.725678364, -13612279.91561769 4559952.866932456, -13612282.36464359 4559964.569899024, -13612283.81161593 4559978.24726071, -13612264.66487271 4559980.925988507, -13612258.65371675 4559981.772197561, -13612234.27491633 4559985.438065836, -13612183.51294916 4559993.475255623, -13612158.57730345 4559997.564404065, -13612128.07574679 4560002.358392327, -13612037.12797755 4560017.022655184, -13612036.90530769 4560017.022643728, -13612006.62641686 4560022.098802805, -13611985.69837552 4560025.341946619, -13611923.24789941 4560035.070861813, -13611902.431481 4560038.454818959, -13611875.04691772 4560042.826227305, -13611793.22692189 4560056.221702476, -13611765.95342475 4560060.874487559, -13611742.46495529 4560064.540432901, -13611672.22268355 4560075.53912284, -13611648.84525108 4560079.345837114, -13611623.79866737 4560083.293895439, -13611548.6582332 4560095.138281453, -13611523.61100282 4560099.08666961, -13611499.12081493 4560103.316712424, -13611425.98385722 4560116.006822396, -13611401.60468581 4560120.378192384, -13611376.22414413 4560124.185230337, -13611299.97035215 4560136.029440344, -13611290.61912191 4560137.43971213))"
